Rk,Player,Pos,Age,Tm,G,GS,MP,FG,FGA,FG%,3P,3PA,3P%,2P,2PA,2P%,eFG%,FT,FTA,FT%,ORB,DRB,TRB,AST,STL,BLK,TOV,PF,PTS
1,Precious Achiuwa\achiupr01,PF,21,MIA,57,3,686,112,208,.538,0,0,,112,208,.538,.538,53,103,.515,70,127,197,27,18,26,41,88,277
2,Jaylen Adams\adamsja01,PG,24,MIL,7,0,18,1,8,.125,0,2,.000,1,6,.167,.125,0,0,,0,3,3,2,0,0,0,1,2
3,Steven Adams\adamsst01,C,27,NOP,57,57,1581,189,305,.620,0,3,.000,189,302,.626,.620,59,133,.444,212,294,506,109,54,37,78,113,437
4,Bam Adebayo\adebaba01,C,23,MIA,58,58,1944,420,738,.569,2,8,.250,418,730,.573,.570,264,329,.802,132,395,527,307,66,61,154,130,1106
5,LaMarcus Aldridge\aldrila01,C,35,TOT,26,23,674,140,296,.473,31,80,.388,109,216,.505,.525,41,47,.872,19,99,118,49,11,29,27,47,352
5,LaMarcus Aldridge\aldrila01,C,35,SAS,21,18,544,115,248,.464,27,75,.360,88,173,.509,.518,31,37,.838,17,77,94,36,8,18,20,36,288
5,LaMarcus Aldridge\aldrila01,C,35,BRK,5,5,130,25,48,.521,4,5,.800,21,43,.488,.563,10,10,1.000,2,22,24,13,3,11,7,11,64
6,Ty-Shon Alexander\alexaty01,SG,22,PHO,11,0,34,2,11,.182,1,8,.125,1,3,.333,.227,1,2,.500,1,4,5,2,0,1,2,1,6
7,Nickeil Alexander-Walker\alexani01,SG,22,NOP,41,10,851,158,378,.418,65,187,.348,93,191,.487,.504,39,52,.750,10,116,126,81,40,21,57,77,420
8,Grayson Allen\allengr01,SG,25,MEM,48,36,1227,173,409,.423,107,270,.396,66,139,.475,.554,75,87,.862,18,137,155,103,45,8,47,71,528
9,Jarrett Allen\allenja01,C,22,TOT,55,37,1613,268,418,.641,5,14,.357,263,404,.651,.647,182,256,.711,168,381,549,89,27,84,85,87,723
9,Jarrett Allen\allenja01,C,22,BRK,12,5,320,44,65,.677,0,0,,44,65,.677,.677,46,61,.754,38,87,125,20,7,19,22,21,134
9,Jarrett Allen\allenja01,C,22,CLE,43,32,1293,224,353,.635,5,14,.357,219,339,.646,.642,136,195,.697,130,294,424,69,20,65,63,66,589
10,Al-Farouq Aminu\aminual01,PF,30,TOT,22,14,418,38,98,.388,8,36,.222,30,62,.484,.429,16,19,.842,21,84,105,31,18,9,28,27,100
10,Al-Farouq Aminu\aminual01,PF,30,ORL,17,14,367,36,89,.404,7,31,.226,29,58,.500,.444,14,17,.824,20,71,91,29,17,9,25,22,93
10,Al-Farouq Aminu\aminual01,PF,30,CHI,5,0,51,2,9,.222,1,5,.200,1,4,.250,.278,2,2,1.000,1,13,14,2,1,0,3,5,7
11,Kyle Anderson\anderky01,PF,27,MEM,61,61,1657,270,583,.463,80,229,.349,190,354,.537,.532,125,160,.781,49,312,361,212,77,49,75,106,745
12,Giannis Antetokounmpo\antetgi01,PF,26,MIL,54,54,1787,557,980,.568,61,195,.313,496,785,.632,.599,356,522,.682,88,512,600,319,65,69,191,145,1531
13,Kostas Antetokounmpo\antetko01,PF,23,LAL,14,0,53,3,10,.300,0,0,,3,10,.300,.300,6,13,.462,4,15,19,1,2,4,10,7,12
14,Thanasis Antetokounmpo\antetth01,SF,28,MIL,51,2,511,67,130,.515,7,27,.259,60,103,.583,.542,19,41,.463,54,68,122,43,19,10,41,70,160
15,Carmelo Anthony\anthoca01,PF,36,POR,63,3,1558,305,725,.421,120,298,.403,185,427,.433,.503,128,145,.883,31,171,202,96,45,35,59,130,858
16,Cole Anthony\anthoco01,PG,20,ORL,39,26,1065,177,446,.397,46,139,.331,131,307,.427,.448,84,102,.824,33,148,181,169,26,17,79,83,484
17,OG Anunoby\anunoog01,SF,23,TOR,43,43,1433,249,519,.480,104,261,.398,145,258,.562,.580,80,102,.784,54,183,237,94,66,32,75,114,682
18,Ryan Arcidiacono\arcidry01,PG,26,CHI,39,0,412,41,103,.398,19,58,.328,22,45,.489,.490,13,20,.650,5,55,60,49,8,0,8,42,114
19,Trevor Ariza\arizatr01,SF,35,MIA,24,21,655,74,182,.407,38,110,.345,36,72,.500,.511,28,38,.737,20,91,111,45,21,16,17,41,214
20,D.J. Augustin\augusdj01,PG,33,TOT,51,6,981,110,286,.385,67,179,.374,43,107,.402,.502,69,74,.932,18,64,82,166,26,1,55,51,356
20,D.J. Augustin\augusdj01,PG,33,MIL,37,6,713,71,192,.370,49,129,.380,22,63,.349,.497,36,40,.900,11,39,50,110,20,1,34,33,227
20,D.J. Augustin\augusdj01,PG,33,HOU,14,0,268,39,94,.415,18,50,.360,21,44,.477,.511,33,34,.971,7,25,32,56,6,0,21,18,129
21,Deni Avdija\avdijde01,SF,20,WAS,54,32,1257,130,312,.417,53,168,.315,77,144,.535,.502,29,45,.644,22,240,262,63,32,15,33,140,342
22,Deandre Ayton\aytonde01,C,22,PHO,64,64,1959,403,651,.619,4,20,.200,399,631,.632,.622,125,164,.762,214,468,682,92,37,71,98,186,935
23,Udoka Azubuike\azubuud01,C,21,UTA,12,0,49,4,7,.571,0,0,,4,7,.571,.571,4,6,.667,4,9,13,0,1,4,3,8,12
24,Dwayne Bacon\bacondw01,SG,25,ORL,64,42,1649,255,632,.403,56,188,.298,199,444,.448,.448,124,148,.838,23,168,191,78,40,4,41,93,690
25,Marvin Bagley III\baglema01,PF,21,SAC,39,38,1006,223,441,.506,36,100,.360,187,341,.548,.546,65,114,.570,96,192,288,39,21,19,54,92,547
26,LaMelo Ball\ballla01,PG,19,CHO,43,23,1232,247,550,.449,82,223,.368,165,327,.505,.524,101,130,.777,54,199,253,264,70,17,125,121,677
27,Lonzo Ball\balllo01,PG,23,NOP,50,50,1577,261,620,.421,154,407,.378,107,213,.502,.545,44,56,.786,28,204,232,292,76,29,108,96,720
28,Mo Bamba\bambamo01,C,22,ORL,40,1,570,116,238,.487,34,93,.366,82,145,.566,.559,28,43,.651,58,143,201,25,10,46,29,73,294
29,Desmond Bane\banede01,SG,22,MEM,59,14,1304,198,425,.466,99,223,.444,99,202,.490,.582,36,43,.837,28,153,181,97,34,11,51,116,531
30,Harrison Barnes\barneha02,PF,28,SAC,58,58,2102,319,642,.497,100,256,.391,219,386,.567,.575,195,235,.830,64,321,385,201,43,11,93,75,933
31,RJ Barrett\barrerj01,SG,20,NYK,64,64,2225,422,941,.448,102,261,.391,320,680,.471,.503,185,249,.743,64,304,368,193,49,17,128,170,1131
32,Will Barton\bartowi01,SF,30,DEN,56,52,1736,259,608,.426,98,257,.381,161,351,.459,.507,95,121,.785,39,187,226,181,50,23,96,95,711
33,Keita Bates-Diop\bateske01,SF,25,SAS,23,0,166,18,44,.409,5,15,.333,13,29,.448,.466,11,17,.647,6,25,31,9,9,3,3,10,52
34,Nicolas Batum\batumni01,SF,32,LAC,61,38,1705,173,379,.456,102,250,.408,71,129,.550,.591,46,54,.852,48,244,292,139,64,33,51,98,494
35,Aron Baynes\baynear01,C,34,TOR,50,31,912,121,281,.431,22,93,.237,99,188,.527,.470,27,37,.730,83,171,254,43,15,20,43,113,291
36,Kent Bazemore\bazemke01,SF,31,GSW,59,10,1094,143,324,.441,64,152,.421,79,172,.459,.540,47,69,.681,25,169,194,95,60,29,70,133,397
37,Darius Bazley\bazleda01,PF,20,OKC,49,49,1531,245,602,.407,72,249,.289,173,353,.490,.467,97,142,.683,44,317,361,82,26,25,106,58,659
38,Bradley Beal\bealbr01,SG,27,WAS,55,55,1952,607,1254,.484,119,343,.347,488,911,.536,.531,374,415,.901,64,194,258,246,64,19,175,130,1707
39,Malik Beasley\beaslma01,SG,24,MIN,37,36,1214,264,600,.440,128,321,.399,136,279,.487,.547,68,80,.850,28,134,162,88,30,7,60,62,724
40,Jordan Bell\belljo01,C,26,WAS,5,1,67,7,20,.350,0,2,.000,7,18,.389,.350,0,0,,6,13,19,5,3,3,3,5,14
41,DeAndre' Bembry\bembrde01,SF,26,TOR,44,11,773,89,168,.530,9,34,.265,80,134,.597,.557,37,54,.685,26,91,117,83,37,15,58,65,224
42,Dāvis Bertāns\bertada01,PF,28,WAS,49,5,1219,160,397,.403,143,358,.399,17,39,.436,.583,84,95,.884,17,130,147,41,29,13,27,116,547
43,Patrick Beverley\beverpa01,PG,32,LAC,31,31,726,82,190,.432,52,125,.416,30,65,.462,.568,33,41,.805,27,84,111,65,26,24,27,97,249
44,Saddiq Bey\beysa01,SF,21,DET,62,45,1624,232,576,.403,148,389,.380,84,187,.449,.531,108,126,.857,36,232,268,82,47,11,50,96,720
45,Tyler Bey\beyty01,SF,22,DAL,12,0,47,6,17,.353,1,3,.333,5,14,.357,.382,3,5,.600,5,8,13,1,0,1,1,5,16
46,Khem Birch\birchkh01,C,28,TOT,60,15,1299,148,301,.492,10,37,.270,138,264,.523,.508,78,112,.696,155,180,335,74,43,42,34,93,384
46,Khem Birch\birchkh01,C,28,ORL,48,5,952,94,209,.450,4,21,.190,90,188,.479,.459,63,85,.741,117,126,243,53,32,28,23,67,255
46,Khem Birch\birchkh01,C,28,TOR,12,10,347,54,92,.587,6,16,.375,48,76,.632,.620,15,27,.556,38,54,92,21,11,14,11,26,129
47,Goga Bitadze\bitadgo01,C,21,IND,37,2,419,70,153,.458,15,56,.268,55,97,.567,.507,34,45,.756,48,71,119,26,8,46,16,71,189
48,Bismack Biyombo\biyombi01,C,28,CHO,58,30,1201,126,216,.583,0,1,.000,126,215,.586,.583,45,101,.446,121,185,306,73,16,66,59,123,297
49,Nemanja Bjelica\bjeline01,PF,32,TOT,35,1,537,78,175,.446,20,74,.270,58,101,.574,.503,34,47,.723,25,92,117,59,11,4,31,64,210
49,Nemanja Bjelica\bjeline01,PF,32,SAC,26,1,439,69,150,.460,17,58,.293,52,92,.565,.517,32,42,.762,24,76,100,49,8,2,28,48,187
49,Nemanja Bjelica\bjeline01,PF,32,MIA,9,0,98,9,25,.360,3,16,.188,6,9,.667,.420,2,5,.400,1,16,17,10,3,2,3,16,23
50,Eric Bledsoe\bledser01,SG,31,NOP,63,62,1878,264,634,.416,111,321,.346,153,313,.489,.504,113,160,.706,26,187,213,230,48,19,101,101,752
51,Keljin Blevins\blevike01,SF,25,POR,13,0,63,4,18,.222,2,7,.286,2,11,.182,.278,0,0,,2,4,6,4,2,0,3,7,10
52,Bogdan Bogdanović\bogdabo01,SG,28,ATL,38,21,1108,216,475,.455,114,274,.416,102,201,.507,.575,33,37,.892,18,126,144,124,37,10,49,85,579
53,Bojan Bogdanović\bogdabo02,SF,31,UTA,64,64,1958,336,790,.425,158,411,.384,178,379,.470,.525,199,227,.877,34,211,245,121,38,4,102,101,1029
54,Bol Bol\bolbo01,PF,21,DEN,28,2,131,24,47,.511,9,20,.450,15,27,.556,.606,9,14,.643,0,19,19,7,3,10,13,13,66
55,Marques Bolden\boldema01,C,22,CLE,6,0,29,1,3,.333,0,0,,1,3,.333,.333,5,8,.625,3,3,6,0,2,2,2,0,7
56,Jordan Bone\bonejo01,PG,23,ORL,14,0,196,23,54,.426,10,32,.313,13,22,.591,.519,0,0,,4,20,24,18,2,0,3,11,56
57,Isaac Bonga\bongais01,SF,21,WAS,39,8,426,30,80,.375,13,46,.283,17,34,.500,.456,5,8,.625,18,48,66,22,11,8,21,60,78
58,Devin Booker\bookede01,SG,24,PHO,60,60,2028,564,1158,.487,116,337,.344,448,821,.546,.537,291,339,.858,27,221,248,265,51,16,191,165,1535
59,Chris Boucher\bouchch01,C,28,TOR,59,13,1415,283,545,.519,88,226,.389,195,319,.611,.600,148,188,.787,116,281,397,63,34,110,46,164,802
60,Brian Bowen\bowenbr02,SF,22,IND,6,0,15,1,4,.250,0,1,.000,1,3,.333,.250,1,1,1.000,0,3,3,0,0,0,0,1,3
61,Avery Bradley\bradlav01,SG,30,TOT,26,5,577,63,165,.382,33,98,.337,30,67,.448,.482,12,15,.800,7,47,54,43,20,4,26,53,171
61,Avery Bradley\bradlav01,SG,30,MIA,10,1,211,31,66,.470,16,38,.421,15,28,.536,.591,7,9,.778,2,16,18,14,7,1,9,26,85
61,Avery Bradley\bradlav01,SG,30,HOU,16,4,366,32,99,.323,17,60,.283,15,39,.385,.409,5,6,.833,5,31,36,29,13,3,17,27,86
62,Tony Bradley\bradlto01,C,23,TOT,38,8,615,118,178,.663,0,3,.000,118,175,.674,.663,34,51,.667,81,136,217,32,15,28,30,56,270
62,Tony Bradley\bradlto01,C,23,PHI,20,8,287,51,75,.680,0,1,.000,51,74,.689,.680,7,11,.636,39,65,104,17,6,13,6,28,109
62,Tony Bradley\bradlto01,C,23,OKC,18,0,328,67,103,.650,0,2,.000,67,101,.663,.650,27,40,.675,42,71,113,15,9,15,24,28,161
63,Jarrell Brantley\brantja01,PF,24,UTA,23,0,116,20,40,.500,10,23,.435,10,17,.588,.625,2,2,1.000,6,17,23,11,5,2,6,16,52
64,Ignas Brazdeikis\brazdig01,SF,22,TOT,5,0,15,0,4,.000,0,1,.000,0,3,.000,.000,2,2,1.000,1,3,4,1,0,0,1,0,2
64,Ignas Brazdeikis\brazdig01,SF,22,NYK,4,0,7,0,1,.000,0,0,,0,1,.000,.000,2,2,1.000,1,1,2,1,0,0,1,0,2
64,Ignas Brazdeikis\brazdig01,SF,22,PHI,1,0,8,0,3,.000,0,1,.000,0,2,.000,.000,0,0,,0,2,2,0,0,0,0,0,0
65,Mikal Bridges\bridgmi01,SF,24,PHO,64,64,2094,318,598,.532,116,285,.407,202,313,.645,.629,95,116,.819,69,208,277,139,65,55,51,103,847
66,Miles Bridges\bridgmi02,PF,22,CHO,64,18,1858,295,583,.506,109,269,.405,186,314,.592,.599,94,109,.862,79,309,388,143,43,48,103,137,793
67,Amida Brimah\brimaam01,C,26,IND,4,0,27,5,8,.625,0,0,,5,8,.625,.625,3,3,1.000,1,6,7,1,0,5,3,4,13
68,Oshae Brissett\brissos01,SF,22,IND,12,7,276,40,79,.506,19,42,.452,21,37,.568,.627,25,34,.735,17,54,71,10,8,17,5,18,124
69,Malcolm Brogdon\brogdma01,PG,28,IND,56,56,1930,444,980,.453,145,374,.388,299,606,.493,.527,153,177,.864,58,236,294,329,49,15,115,110,1186
70,Armoni Brooks\brookar01,SG,22,HOU,13,5,291,32,96,.333,27,82,.329,5,14,.357,.474,3,7,.429,6,39,45,15,4,2,14,18,94
71,Dillon Brooks\brookdi01,SF,25,MEM,59,59,1733,373,889,.420,111,322,.345,262,567,.462,.482,137,163,.840,47,125,172,135,68,22,110,205,994
72,Bruce Brown\brownbr01,PG,24,BRK,58,32,1278,203,372,.546,16,55,.291,187,317,.590,.567,78,106,.736,97,201,298,90,53,21,50,131,500
73,Charlie Brown\brownch02,SG,23,OKC,3,1,48,5,19,.263,3,11,.273,2,8,.250,.342,2,2,1.000,1,6,7,2,3,1,3,4,15
74,Jaylen Brown\brownja02,SG,24,BOS,58,58,1999,538,1111,.484,163,411,.397,375,700,.536,.558,191,250,.764,71,276,347,195,72,32,158,168,1430
75,Moses Brown\brownmo01,C,21,OKC,36,25,732,120,215,.558,0,0,,120,215,.558,.558,65,105,.619,120,183,303,7,24,34,38,77,305
76,Sterling Brown\brownst02,SG,25,HOU,51,14,1229,150,335,.448,91,215,.423,59,120,.492,.584,25,31,.806,38,186,224,72,38,12,41,97,416
77,Troy Brown Jr.\browntr01,SF,21,TOT,34,0,524,62,144,.431,22,70,.314,40,74,.541,.507,15,21,.714,20,85,105,29,10,6,21,49,161
77,Troy Brown Jr.\browntr01,SF,21,WAS,21,0,287,33,89,.371,14,46,.304,19,43,.442,.449,10,15,.667,11,50,61,19,3,4,16,29,90
77,Troy Brown Jr.\browntr01,SF,21,CHI,13,0,237,29,55,.527,8,24,.333,21,31,.677,.600,5,6,.833,9,35,44,10,7,2,5,20,71
78,Jalen Brunson\brunsja01,PG,24,DAL,60,12,1513,286,551,.519,67,174,.385,219,377,.581,.580,109,138,.790,27,185,212,206,30,0,72,96,748
79,Thomas Bryant\bryanth01,C,23,WAS,10,10,271,59,91,.648,9,21,.429,50,70,.714,.698,16,24,.667,18,43,61,15,4,8,11,31,143
80,Reggie Bullock\bullore01,SF,29,NYK,57,56,1649,212,476,.445,139,336,.414,73,140,.521,.591,37,42,.881,13,178,191,84,44,9,39,127,600
81,Trey Burke\burketr01,PG,28,DAL,54,1,807,138,311,.444,54,144,.375,84,167,.503,.531,43,49,.878,6,40,46,75,34,5,30,56,373
82,Alec Burks\burksal01,SG,29,NYK,44,5,1134,184,444,.414,89,218,.408,95,226,.420,.515,96,111,.865,19,179,198,96,30,12,44,91,553
83,Jimmy Butler\butleji01,SF,31,MIA,48,48,1622,340,689,.493,19,93,.204,321,596,.539,.507,332,384,.865,87,249,336,345,100,18,101,67,1031
84,Bruno Caboclo\cabocbr01,PF,25,HOU,6,0,36,8,17,.471,0,5,.000,8,12,.667,.471,1,2,.500,3,11,14,1,0,2,4,6,17
85,Devontae Cacok\cacokde01,PF,24,LAL,18,1,90,17,27,.630,0,0,,17,27,.630,.630,4,9,.444,10,20,30,1,5,4,5,8,38
86,Kentavious Caldwell-Pope\caldwke01,SG,27,LAL,59,59,1640,190,444,.428,105,254,.413,85,190,.447,.546,77,89,.865,23,129,152,100,53,20,57,96,562
87,Facundo Campazzo\campafa01,PG,29,DEN,58,12,1204,101,258,.391,67,180,.372,34,78,.436,.521,63,73,.863,18,84,102,189,61,12,62,120,332
88,Vlatko Čančar\cancavl01,PF,23,DEN,35,0,187,19,44,.432,6,23,.261,13,21,.619,.500,7,8,.875,6,30,36,10,9,2,12,14,51
89,Devin Cannady\cannade01,PG,24,ORL,8,0,74,11,28,.393,6,16,.375,5,12,.417,.500,6,7,.857,0,5,5,1,5,1,2,9,34
90,Clint Capela\capelca01,C,26,ATL,57,57,1720,379,641,.591,0,0,,379,641,.591,.591,118,208,.567,275,552,827,46,40,119,65,130,876
91,Vernon Carey Jr.\careyve01,C,19,CHO,16,4,100,16,31,.516,1,7,.143,15,24,.625,.532,8,9,.889,4,19,23,2,1,4,5,11,41
92,Jevon Carter\carteje01,PG,25,PHO,52,0,598,76,184,.413,47,130,.362,29,54,.537,.541,3,6,.500,13,64,77,60,25,9,13,52,202
93,Wendell Carter Jr.\cartewe01,C,21,TOT,50,40,1276,218,423,.515,14,45,.311,204,378,.540,.532,125,171,.731,120,285,405,98,34,39,75,137,575
93,Wendell Carter Jr.\cartewe01,C,21,CHI,32,25,792,129,252,.512,8,22,.364,121,230,.526,.528,82,111,.739,70,180,250,69,18,24,49,96,348
93,Wendell Carter Jr.\cartewe01,C,21,ORL,18,15,484,89,171,.520,6,23,.261,83,148,.561,.538,43,60,.717,50,105,155,29,16,15,26,41,227
94,Michael Carter-Williams\cartemi01,SG,29,ORL,31,25,800,105,270,.389,15,61,.246,90,209,.431,.417,49,80,.613,39,100,139,129,25,17,69,81,274
95,Alex Caruso\carusal01,PG,26,LAL,52,1,1067,108,252,.429,48,120,.400,60,132,.455,.524,43,65,.662,27,124,151,133,58,13,63,94,307
96,Willie Cauley-Stein\caulewi01,C,27,DAL,45,11,776,99,158,.627,1,10,.100,98,148,.662,.630,45,72,.625,57,141,198,29,17,36,23,106,244
97,Chris Chiozza\chiozch01,PG,25,BRK,22,1,232,31,88,.352,13,42,.310,18,46,.391,.426,13,17,.765,3,21,24,65,7,6,16,19,88
98,Marquese Chriss\chrisma01,PF,23,GSW,2,0,27,5,14,.357,1,5,.200,4,9,.444,.393,2,4,.500,3,10,13,2,0,2,2,3,13
99,Gary Clark\clarkga01,SF,26,TOT,37,11,641,40,131,.305,31,108,.287,9,23,.391,.424,8,10,.800,33,80,113,30,12,7,17,34,119
99,Gary Clark\clarkga01,SF,26,ORL,35,11,637,40,131,.305,31,108,.287,9,23,.391,.424,8,10,.800,33,79,112,30,12,7,17,34,119
99,Gary Clark\clarkga01,SF,26,DEN,2,0,4,0,0,,0,0,,0,0,,,0,0,,0,1,1,0,0,0,0,0,0
100,Brandon Clarke\clarkbr01,PF,24,MEM,52,16,1282,232,448,.518,19,68,.279,213,380,.561,.539,67,98,.684,78,207,285,89,54,43,31,74,550
101,Jordan Clarkson\clarkjo01,SG,28,UTA,60,1,1570,379,913,.415,178,518,.344,201,395,.509,.513,106,115,.922,43,194,237,138,53,9,100,91,1042
102,Nicolas Claxton\claxtni01,C,21,BRK,25,1,462,70,120,.583,1,5,.200,69,115,.600,.588,23,46,.500,35,89,124,27,19,30,14,52,164
103,Amir Coffey\coffeam01,SG,23,LAC,44,1,394,45,103,.437,23,56,.411,22,47,.468,.549,27,38,.711,10,34,44,22,10,0,15,30,140
104,John Collins\collijo01,PF,23,ATL,56,56,1673,386,702,.550,70,184,.380,316,518,.610,.600,147,176,.835,111,313,424,75,31,56,73,172,989
105,Mike Conley\conlemi01,PG,33,UTA,49,49,1459,278,623,.446,134,329,.407,144,294,.490,.554,116,136,.853,35,134,169,293,67,9,98,94,806
106,Pat Connaughton\connapa01,SG,28,MIL,61,3,1399,151,341,.443,91,237,.384,60,104,.577,.576,26,35,.743,57,231,288,73,44,21,29,91,419
107,Quinn Cook\cookqu01,PG,27,TOT,23,0,157,29,68,.426,11,26,.423,18,42,.429,.507,7,8,.875,2,15,17,18,4,1,7,10,76
107,Quinn Cook\cookqu01,PG,27,LAL,16,0,62,12,26,.462,5,13,.385,7,13,.538,.558,4,5,.800,0,5,5,5,1,1,3,2,33
107,Quinn Cook\cookqu01,PG,27,CLE,7,0,95,17,42,.405,6,13,.462,11,29,.379,.476,3,3,1.000,2,10,12,13,3,0,4,8,43
108,Tyler Cook\cookty01,SF-PF,23,TOT,24,1,282,40,66,.606,0,1,.000,40,65,.615,.606,11,21,.524,22,40,62,13,5,0,16,26,91
108,Tyler Cook\cookty01,PF,23,BRK,4,0,17,1,3,.333,0,0,,1,3,.333,.333,0,0,,1,1,2,2,0,0,1,2,2
108,Tyler Cook\cookty01,SF,23,DET,20,1,265,39,63,.619,0,1,.000,39,62,.629,.619,11,21,.524,21,39,60,11,5,0,15,24,89
109,DeMarcus Cousins\couside01,C,30,TOT,35,11,637,111,274,.405,45,130,.346,66,144,.458,.487,56,78,.718,48,193,241,72,25,22,58,94,323
109,DeMarcus Cousins\couside01,C,30,HOU,25,11,506,79,210,.376,39,116,.336,40,94,.426,.469,44,59,.746,30,161,191,60,21,18,39,74,241
109,DeMarcus Cousins\couside01,C,30,LAC,10,0,131,32,64,.500,6,14,.429,26,50,.520,.547,12,19,.632,18,32,50,12,4,4,19,20,82
110,Robert Covington\covinro01,PF,30,POR,62,62,1991,186,457,.407,120,314,.382,66,143,.462,.538,47,57,.825,54,363,417,104,89,76,62,168,539
111,Torrey Craig\craigto01,SF,30,TOT,42,4,636,85,173,.491,30,79,.380,55,94,.585,.578,13,18,.722,45,114,159,39,24,23,20,63,213
111,Torrey Craig\craigto01,SF,30,MIL,18,0,201,18,46,.391,8,22,.364,10,24,.417,.478,1,2,.500,13,30,43,16,9,7,5,24,45
111,Torrey Craig\craigto01,SF,30,PHO,24,4,435,67,127,.528,22,57,.386,45,70,.643,.614,12,16,.750,32,84,116,23,15,16,15,39,168
112,Jae Crowder\crowdja01,PF,30,PHO,55,39,1508,179,446,.401,130,341,.381,49,105,.467,.547,51,67,.761,30,236,266,118,44,23,52,108,539
113,Jarrett Culver\culveja01,SG,21,MIN,34,7,499,69,168,.411,13,53,.245,56,115,.487,.449,29,48,.604,34,70,104,24,17,9,28,58,180
114,Seth Curry\curryse01,SG,30,PHI,51,51,1466,227,498,.456,108,247,.437,119,251,.474,.564,64,71,.901,10,103,113,137,40,8,60,83,626
115,Stephen Curry\curryst01,PG,32,GSW,56,56,1905,572,1178,.486,291,683,.426,281,495,.568,.609,316,345,.916,25,285,310,323,67,7,188,103,1751
116,Nate Darling\darlina01,SG,22,CHO,6,0,24,2,7,.286,2,7,.286,0,0,,.429,3,3,1.000,1,0,1,1,0,1,1,1,9
117,Anthony Davis\davisan02,PF,27,LAL,29,29,930,243,482,.504,21,81,.259,222,401,.554,.526,110,154,.714,53,180,233,89,38,52,58,53,617
118,Ed Davis\davised01,C,31,MIN,22,7,293,19,44,.432,0,0,,19,44,.432,.432,10,12,.833,46,67,113,21,13,13,7,54,48
119,Terence Davis\daviste02,SG,23,TOT,53,4,842,145,344,.422,75,205,.366,70,139,.504,.531,27,33,.818,14,100,114,62,30,11,50,77,392
119,Terence Davis\daviste02,SG,23,TOR,34,4,493,87,210,.414,44,122,.361,43,88,.489,.519,16,18,.889,9,57,66,37,17,7,29,48,234
119,Terence Davis\daviste02,SG,23,SAC,19,0,349,58,134,.433,31,83,.373,27,51,.529,.549,11,15,.733,5,43,48,25,13,4,21,29,158
120,Gabriel Deck\deckga01,PF,25,OKC,3,0,57,9,23,.391,0,6,.000,9,17,.529,.391,3,5,.600,9,9,18,7,2,0,2,3,21
121,Dewayne Dedmon\dedmode01,C,31,MIA,10,0,133,32,44,.727,0,3,.000,32,41,.780,.727,19,22,.864,21,38,59,4,6,5,9,19,83
122,Matthew Dellavedova\dellama01,PG,30,CLE,13,1,224,14,56,.250,4,25,.160,10,31,.323,.286,4,4,1.000,6,18,24,58,4,1,6,21,36
123,DeMar DeRozan\derozde01,PF,31,SAS,53,53,1817,393,803,.489,18,73,.247,375,730,.514,.501,345,390,.885,39,194,233,390,47,13,104,109,1149
124,Mamadi Diakite\diakima01,PF,24,MIL,12,0,102,12,29,.414,1,7,.143,11,22,.500,.431,6,6,1.000,6,21,27,6,4,5,3,12,31
125,Hamidou Diallo\diallha01,SG-SF,22,TOT,48,5,1095,193,412,.468,21,64,.328,172,348,.494,.494,113,177,.638,55,186,241,95,40,21,70,123,520
125,Hamidou Diallo\diallha01,SG,22,OKC,32,5,761,143,297,.481,12,41,.293,131,256,.512,.502,83,132,.629,37,128,165,77,31,12,49,83,381
125,Hamidou Diallo\diallha01,SF,22,DET,16,0,334,50,115,.435,9,23,.391,41,92,.446,.474,30,45,.667,18,58,76,18,9,9,21,40,139
126,Gorgui Dieng\dienggo01,C,31,TOT,31,1,468,67,127,.528,28,59,.475,39,68,.574,.638,50,58,.862,33,87,120,36,21,15,27,50,212
126,Gorgui Dieng\dienggo01,C,31,MEM,22,1,371,56,108,.519,23,48,.479,33,60,.550,.625,38,43,.884,28,70,98,29,17,14,22,38,173
126,Gorgui Dieng\dienggo01,C,31,SAS,9,0,97,11,19,.579,5,11,.455,6,8,.750,.711,12,15,.800,5,17,22,7,4,1,5,12,39
127,Spencer Dinwiddie\dinwisp01,SG,27,BRK,3,3,64,6,16,.375,2,7,.286,4,9,.444,.438,6,6,1.000,0,13,13,9,2,1,5,4,20
128,Donte DiVincenzo\divindo01,SG,24,MIL,59,59,1617,219,535,.409,111,298,.372,108,237,.456,.513,42,57,.737,71,258,329,179,66,13,82,95,591
129,Luka Dončić\doncilu01,PG,21,DAL,58,58,2040,590,1214,.486,171,484,.353,419,730,.574,.556,310,426,.728,47,416,463,515,58,34,250,138,1661
130,Luguentz Dort\dortlu01,SG,21,OKC,49,49,1469,236,597,.395,107,308,.347,129,289,.446,.485,117,156,.750,33,146,179,80,44,19,76,125,696
131,Damyean Dotson\dotsoda01,SG,26,CLE,39,6,740,97,245,.396,37,130,.285,60,115,.522,.471,23,34,.676,5,73,78,81,14,4,32,39,254
132,Devon Dotson\dotsode01,PG,21,CHI,7,0,23,4,8,.500,0,1,.000,4,7,.571,.500,0,0,,2,1,3,2,2,0,0,1,8
133,Sekou Doumbouya\doumbse01,PF,20,DET,50,6,701,79,222,.356,23,97,.237,56,125,.448,.408,35,49,.714,28,83,111,37,20,5,36,79,216
134,PJ Dozier\doziepj01,SG,24,DEN,49,5,1067,147,349,.421,46,147,.313,101,202,.500,.487,42,66,.636,35,145,180,91,31,22,46,84,382
135,Goran Dragić\dragigo01,PG,34,MIA,44,11,1173,205,474,.432,72,205,.351,133,269,.494,.508,90,109,.826,21,131,152,198,31,8,105,98,572
136,Andre Drummond\drumman01,C,27,TOT,38,38,1049,248,507,.489,0,8,.000,248,499,.497,.489,108,176,.614,139,331,470,84,58,41,109,118,604
136,Andre Drummond\drumman01,C,27,CLE,25,25,722,180,380,.474,0,8,.000,180,372,.484,.474,77,129,.597,101,236,337,64,40,29,81,69,437
136,Andre Drummond\drumman01,C,27,LAL,13,13,327,68,127,.535,0,0,,68,127,.535,.535,31,47,.660,38,95,133,20,18,12,28,49,167
137,Jared Dudley\dudleja01,PF,35,LAL,11,0,76,2,7,.286,2,5,.400,0,2,.000,.429,0,0,,4,15,19,5,1,1,2,7,6
138,Kris Dunn\dunnkr01,PG,26,ATL,3,0,42,1,11,.091,0,2,.000,1,9,.111,.091,3,4,.750,0,4,4,2,2,2,3,9,5
139,Kevin Durant\duranke01,PF,32,BRK,28,25,921,272,496,.548,75,157,.478,197,339,.581,.624,169,193,.876,11,179,190,145,20,34,100,56,788
140,Anthony Edwards\edwaran01,SG,19,MIN,65,48,2060,438,1088,.403,147,463,.317,291,625,.466,.470,182,235,.774,53,248,301,179,76,29,143,111,1205
141,Carsen Edwards\edwarca01,SG,22,BOS,25,1,212,39,86,.453,13,46,.283,26,40,.650,.529,7,9,.778,3,19,22,11,5,1,4,22,98
142,CJ Elleby\ellebcj01,SF,20,POR,24,0,168,21,56,.375,7,31,.226,14,25,.560,.438,9,13,.692,10,16,26,6,6,3,5,25,58
143,Henry Ellenson\ellenhe01,PF,24,TOR,2,0,38,5,14,.357,2,9,.222,3,5,.600,.429,3,4,.750,3,9,12,5,0,0,0,7,15
144,Wayne Ellington\ellinwa01,SG,33,DET,44,30,962,142,319,.445,109,259,.421,33,60,.550,.616,28,35,.800,12,70,82,63,17,9,29,59,421
145,Joel Embiid\embiijo01,C,26,PHI,45,45,1424,419,818,.512,53,141,.376,366,677,.541,.545,428,501,.854,102,383,485,133,46,62,140,110,1319
146,James Ennis\ennisja01,SF,30,ORL,41,37,986,115,243,.473,45,104,.433,70,139,.504,.566,70,87,.805,43,123,166,62,32,7,36,84,345
147,Drew Eubanks\eubandr01,C,23,SAS,45,2,626,96,166,.578,1,1,1.000,95,165,.576,.581,60,87,.690,55,136,191,36,17,43,39,71,253
148,Dante Exum\exumda01,SG,25,CLE,6,3,116,10,26,.385,2,11,.182,8,15,.533,.423,1,2,.500,2,15,17,13,4,2,7,9,23
149,Tacko Fall\fallta01,C,25,BOS,15,0,100,18,24,.750,0,0,,18,24,.750,.750,4,13,.308,11,27,38,2,1,12,4,16,40
150,Derrick Favors\favorde01,C,29,UTA,60,0,921,138,218,.633,0,2,.000,138,216,.639,.633,55,74,.743,126,206,332,42,30,61,34,132,331
151,Cristiano Felício\feliccr01,C,28,CHI,14,0,59,4,7,.571,0,1,.000,4,6,.667,.571,6,10,.600,6,8,14,8,2,0,4,7,14
152,Terrance Ferguson\fergute01,SG,22,PHI,13,0,49,1,7,.143,0,5,.000,1,2,.500,.143,0,0,,0,1,1,2,1,0,4,7,2
153,Bruno Fernando\fernabr01,C,22,ATL,30,0,198,13,33,.394,0,2,.000,13,31,.419,.394,13,20,.650,15,53,68,9,2,3,20,20,39
154,Yogi Ferrell\ferreyo01,PG,27,TOT,5,0,69,12,31,.387,6,15,.400,6,16,.375,.484,3,5,.600,3,5,8,15,4,1,3,5,33
154,Yogi Ferrell\ferreyo01,PG,27,CLE,2,0,40,8,21,.381,3,9,.333,5,12,.417,.452,0,2,.000,3,4,7,5,3,1,3,4,19
154,Yogi Ferrell\ferreyo01,PG,27,LAC,3,0,29,4,10,.400,3,6,.500,1,4,.250,.550,3,3,1.000,0,1,1,10,1,0,0,1,14
155,Dorian Finney-Smith\finnedo01,PF,27,DAL,52,52,1689,188,406,.463,105,266,.395,83,140,.593,.592,28,35,.800,90,201,291,85,49,22,38,122,509
156,Malik Fitts\fittsma01,PF,23,LAC,3,0,11,1,3,.333,1,2,.500,0,1,.000,.500,0,0,,0,3,3,0,0,0,0,3,3
157,Malachi Flynn\flynnma01,PG,22,TOR,40,9,719,91,247,.368,38,121,.314,53,126,.421,.445,33,40,.825,8,80,88,109,30,5,36,54,253
158,Bryn Forbes\forbebr01,SG,27,MIL,63,10,1218,223,479,.466,136,307,.443,87,172,.506,.608,43,55,.782,11,90,101,38,22,0,37,66,625
159,Trent Forrest\forretr01,PG,22,UTA,22,0,160,14,32,.438,2,10,.200,12,22,.545,.469,6,6,1.000,0,13,13,32,4,3,12,10,36
160,Evan Fournier\fournev01,SF-SG,28,TOT,36,30,1065,202,454,.445,93,239,.389,109,215,.507,.547,104,131,.794,7,98,105,114,41,14,67,80,601
160,Evan Fournier\fournev01,SF,28,ORL,26,26,787,170,369,.461,73,188,.388,97,181,.536,.560,98,123,.797,5,70,75,95,27,9,54,55,511
160,Evan Fournier\fournev01,SG,28,BOS,10,4,278,32,85,.376,20,51,.392,12,34,.353,.494,6,8,.750,2,28,30,19,14,5,13,25,90
161,De'Aaron Fox\foxde01,PG,23,SAC,58,58,2036,529,1110,.477,103,320,.322,426,790,.539,.523,300,417,.719,33,170,203,417,87,27,174,170,1461
162,Robert Franks\frankro01,PF,24,ORL,7,0,101,13,28,.464,5,15,.333,8,13,.615,.554,12,13,.923,6,8,14,5,3,3,2,8,43
163,Tim Frazier\fraziti01,PG,30,MEM,3,0,33,2,8,.250,0,2,.000,2,6,.333,.250,0,0,,0,4,4,7,1,0,3,4,4
164,Markelle Fultz\fultzma01,PG,22,ORL,8,8,215,41,104,.394,4,16,.250,37,88,.420,.413,17,19,.895,5,20,25,43,8,2,18,18,103
165,Wenyen Gabriel\gabriwe01,PF,23,NOP,14,0,103,8,22,.364,4,10,.400,4,12,.333,.455,4,7,.571,8,14,22,8,4,3,11,13,24
166,Daniel Gafford\gaffoda01,PF-C,22,TOT,46,11,661,126,184,.685,0,0,,126,184,.685,.685,55,87,.632,78,117,195,23,22,63,35,82,307
166,Daniel Gafford\gaffoda01,PF,22,CHI,31,11,383,60,87,.690,0,0,,60,87,.690,.690,27,41,.659,44,59,103,17,11,34,22,54,147
166,Daniel Gafford\gaffoda01,C,22,WAS,15,0,278,66,97,.680,0,0,,66,97,.680,.680,28,46,.609,34,58,92,6,11,29,13,28,160
167,Danilo Gallinari\gallida01,PF,32,ATL,45,4,1070,176,417,.422,92,228,.404,84,189,.444,.532,151,161,.938,15,164,179,63,23,7,41,93,595
168,Langston Galloway\gallola01,SG,29,PHO,36,0,386,58,123,.472,32,71,.451,26,52,.500,.602,17,17,1.000,5,33,38,24,8,0,13,23,165
169,Darius Garland\garlada01,PG,21,CLE,53,50,1778,361,799,.452,104,264,.394,257,535,.480,.517,112,132,.848,23,106,129,327,65,6,163,110,938
170,Marc Gasol\gasolma01,C,36,LAL,46,42,886,82,182,.451,44,112,.393,38,70,.543,.571,34,46,.739,36,152,188,94,23,54,52,101,242
171,Rudy Gay\gayru01,PF,34,SAS,55,1,1203,231,549,.421,91,235,.387,140,314,.446,.504,72,91,.791,39,228,267,80,38,31,59,105,625
172,Paul George\georgpa01,SF,30,LAC,49,49,1646,409,871,.470,157,373,.421,252,498,.506,.560,184,211,.872,42,279,321,257,60,22,161,119,1159
173,Taj Gibson\gibsota01,PF,35,NYK,37,2,760,79,126,.627,3,14,.214,76,112,.679,.639,31,45,.689,81,121,202,26,28,34,20,79,192
174,Harry Giles\gilesha01,C,22,POR,33,0,324,35,83,.422,8,18,.444,27,65,.415,.470,15,22,.682,30,93,123,25,6,10,19,52,93
175,Shai Gilgeous-Alexander\gilgesh01,SG,22,OKC,35,35,1180,287,565,.508,71,170,.418,216,395,.547,.571,185,229,.808,19,147,166,207,27,23,106,70,830
176,Anthony Gill\gillan01,PF,28,WAS,22,2,162,23,42,.548,6,20,.300,17,22,.773,.619,5,8,.625,14,28,42,10,8,3,6,21,57
177,Freddie Gillespie\gillefr01,PF,23,TOR,13,0,205,29,51,.569,0,0,,29,51,.569,.569,14,18,.778,22,27,49,5,6,12,6,27,72
178,Rudy Gobert\goberru01,C,28,UTA,63,63,1949,346,510,.678,0,3,.000,346,507,.682,.678,208,335,.621,210,635,845,79,34,177,103,148,900
179,Brandon Goodwin\goodwbr01,PG,25,ATL,45,5,609,81,219,.370,31,102,.304,50,117,.427,.441,27,41,.659,8,60,68,92,15,0,36,40,220
180,Aaron Gordon\gordoaa01,PF,25,TOT,44,44,1236,209,449,.465,57,164,.348,152,285,.533,.529,94,144,.653,67,189,256,151,29,30,91,81,569
180,Aaron Gordon\gordoaa01,PF,25,ORL,25,25,736,128,293,.437,42,112,.375,86,181,.475,.509,66,105,.629,39,127,166,105,16,20,67,49,364
180,Aaron Gordon\gordoaa01,PF,25,DEN,19,19,500,81,156,.519,15,52,.288,66,104,.635,.567,28,39,.718,28,62,90,46,13,10,24,32,205
181,Eric Gordon\gordoer01,SG,32,HOU,27,13,789,159,367,.433,69,210,.329,90,157,.573,.527,94,114,.825,8,50,58,71,14,13,51,44,481
182,Devonte' Graham\grahade01,PG,25,CHO,51,44,1531,231,618,.374,163,437,.373,68,181,.376,.506,115,140,.821,19,118,137,275,47,6,81,73,740
183,Jerami Grant\grantje01,SF,26,DET,53,53,1805,395,922,.428,115,325,.354,280,597,.469,.491,286,337,.849,35,211,246,151,35,56,106,124,1191
184,Danny Green\greenda02,SF,33,PHI,62,62,1749,202,488,.414,156,385,.405,46,103,.447,.574,27,35,.771,51,181,232,106,82,53,62,117,587
185,Draymond Green\greendr01,PF,30,GSW,56,56,1734,143,332,.431,28,113,.248,115,219,.525,.473,56,72,.778,48,337,385,482,92,45,166,177,370
186,JaMychal Green\greenja01,PF,30,DEN,50,4,938,152,319,.476,70,168,.417,82,151,.543,.586,40,48,.833,74,171,245,40,24,19,46,124,414
187,Javonte Green\greenja02,SG-PG,27,TOT,33,2,380,40,79,.506,7,23,.304,33,56,.589,.551,22,32,.688,22,37,59,13,20,4,17,35,109
187,Javonte Green\greenja02,SG,27,BOS,25,2,345,39,71,.549,7,22,.318,32,49,.653,.599,20,30,.667,20,32,52,11,18,2,13,32,105
187,Javonte Green\greenja02,PG,27,CHI,8,0,35,1,8,.125,0,1,.000,1,7,.143,.125,2,2,1.000,2,5,7,2,2,2,4,3,4
188,Jeff Green\greenje02,C,34,BRK,61,37,1671,227,476,.477,85,220,.386,142,256,.555,.566,113,143,.790,30,210,240,103,35,25,47,110,652
189,Josh Green\greenjo02,SG,20,DAL,32,5,333,30,70,.429,3,20,.150,27,50,.540,.450,9,15,.600,21,39,60,18,10,3,16,23,72
190,Blake Griffin\griffbl01,PF,31,TOT,39,24,1018,145,356,.407,60,181,.331,85,175,.486,.492,79,107,.738,27,172,199,121,28,13,56,94,429
190,Blake Griffin\griffbl01,PF,31,DET,20,20,626,81,222,.365,39,124,.315,42,98,.429,.453,44,62,.710,7,97,104,77,14,2,32,42,245
190,Blake Griffin\griffbl01,PF,31,BRK,19,4,392,64,134,.478,21,57,.368,43,77,.558,.556,35,45,.778,20,75,95,44,14,11,24,52,184
191,Kyle Guy\guyky01,PG,23,SAC,25,0,176,25,68,.368,10,36,.278,15,32,.469,.441,14,16,.875,4,21,25,21,4,0,6,15,74
192,Rui Hachimura\hachiru01,PF,22,WAS,51,51,1605,264,559,.472,40,122,.328,224,437,.513,.508,120,156,.769,44,237,281,75,42,5,63,111,688
193,Ashton Hagans\haganas01,PG,21,MIN,2,0,4,0,0,,0,0,,0,0,,,0,0,,0,0,0,0,0,0,1,0,0
194,Tyrese Haliburton\halibty01,PG,20,SAC,58,20,1746,292,619,.472,121,296,.409,171,323,.529,.569,48,56,.857,39,134,173,309,77,28,92,83,753
195,Donta Hall\halldo01,PF,23,ORL,8,0,92,9,14,.643,0,0,,9,14,.643,.643,7,12,.583,14,21,35,7,4,6,3,8,25
196,Josh Hall\halljo01,SF,20,OKC,16,0,205,12,53,.226,2,22,.091,10,31,.323,.245,18,33,.545,3,29,32,22,1,1,18,22,44
197,R.J. Hampton\hamptrj01,PG-SG,19,TOT,44,1,677,95,222,.428,19,67,.284,76,155,.490,.471,35,51,.686,22,107,129,47,20,7,41,54,244
197,R.J. Hampton\hamptrj01,PG,19,DEN,25,0,233,25,60,.417,5,18,.278,20,42,.476,.458,9,12,.750,10,40,50,14,5,2,11,22,64
197,R.J. Hampton\hamptrj01,SG,19,ORL,19,1,444,70,162,.432,14,49,.286,56,113,.496,.475,26,39,.667,12,67,79,33,15,5,30,32,180
198,Tim Hardaway Jr.\hardati02,SG,28,DAL,62,23,1753,348,797,.437,174,456,.382,174,341,.510,.546,121,150,.807,17,188,205,106,27,9,58,100,991
199,James Harden\hardeja01,PG-SG,31,TOT,42,42,1558,334,722,.463,117,327,.358,217,395,.549,.544,275,316,.870,35,301,336,457,50,29,173,95,1060
199,James Harden\hardeja01,SG,31,HOU,8,8,290,60,135,.444,25,72,.347,35,63,.556,.537,53,60,.883,5,36,41,83,7,6,34,14,198
199,James Harden\hardeja01,PG,31,BRK,34,34,1268,274,587,.467,92,255,.361,182,332,.548,.545,222,256,.867,30,265,295,374,43,23,139,81,862
200,Maurice Harkless\harklma01,PF-SF,27,TOT,30,16,577,44,108,.407,16,57,.281,28,51,.549,.481,23,28,.821,10,52,62,27,21,15,18,67,127
200,Maurice Harkless\harklma01,SF,27,MIA,11,3,124,5,13,.385,5,11,.455,0,2,.000,.577,0,2,.000,2,11,13,7,2,4,3,14,15
200,Maurice Harkless\harklma01,PF,27,SAC,19,13,453,39,95,.411,11,46,.239,28,49,.571,.468,23,26,.885,8,41,49,20,19,11,15,53,112
201,Jared Harper\harpeja01,PG,23,NYK,6,0,13,0,4,.000,0,1,.000,0,3,.000,.000,2,2,1.000,0,1,1,0,0,0,2,1,2
202,Montrezl Harrell\harremo01,C,27,LAL,63,1,1487,352,561,.627,0,10,.000,352,551,.639,.627,166,234,.709,148,254,402,68,45,47,70,122,870
203,Gary Harris\harriga01,SG,26,TOT,31,30,915,112,281,.399,37,112,.330,75,169,.444,.464,58,72,.806,17,53,70,67,25,9,30,64,319
203,Gary Harris\harriga01,SG,26,DEN,19,19,581,69,156,.442,24,75,.320,45,81,.556,.519,22,30,.733,13,34,47,32,17,4,14,37,184
203,Gary Harris\harriga01,SG,26,ORL,12,11,334,43,125,.344,13,37,.351,30,88,.341,.396,36,42,.857,4,19,23,35,8,5,16,27,135
204,Jalen Harris\harrija01,SG,22,TOR,7,0,32,3,11,.273,3,5,.600,0,6,.000,.409,0,0,,2,3,5,4,3,0,2,5,9
205,Joe Harris\harrijo01,SF,29,BRK,65,61,2008,340,666,.511,201,419,.480,139,247,.563,.661,47,61,.770,41,189,230,123,44,14,55,129,928
206,Tobias Harris\harrito02,PF,28,PHI,55,55,1797,422,818,.516,75,187,.401,347,631,.550,.562,163,183,.891,54,329,383,201,50,48,100,109,1082
207,Shaquille Harrison\harrish01,SG,27,TOT,26,0,185,19,47,.404,1,5,.200,18,42,.429,.415,13,16,.813,5,21,26,14,12,2,8,16,52
207,Shaquille Harrison\harrish01,SG,27,UTA,17,0,56,6,20,.300,0,2,.000,6,18,.333,.300,5,6,.833,3,6,9,9,2,0,5,3,17
207,Shaquille Harrison\harrish01,SG,27,DEN,9,0,129,13,27,.481,1,3,.333,12,24,.500,.500,8,10,.800,2,15,17,5,10,2,3,13,35
208,Josh Hart\hartjo01,SF,25,NOP,47,4,1349,151,344,.439,63,193,.326,88,151,.583,.531,69,89,.775,53,324,377,109,38,12,49,111,434
209,Isaiah Hartenstein\harteis01,C,22,TOT,44,2,533,90,158,.570,2,5,.400,88,153,.575,.576,44,69,.638,63,114,177,49,18,38,42,99,226
209,Isaiah Hartenstein\harteis01,C,22,DEN,30,0,272,41,80,.513,0,0,,41,80,.513,.513,22,36,.611,40,45,85,15,11,20,21,59,104
209,Isaiah Hartenstein\harteis01,C,22,CLE,14,2,261,49,78,.628,2,5,.400,47,73,.644,.641,22,33,.667,23,69,92,34,7,18,21,40,122
210,Jaxson Hayes\hayesja02,C,20,NOP,52,3,786,131,201,.652,3,7,.429,128,194,.660,.659,73,92,.793,69,136,205,27,19,27,33,91,338
211,Killian Hayes\hayeski01,PG,19,DET,19,12,449,45,135,.333,11,44,.250,34,91,.374,.374,8,9,.889,5,40,45,92,22,7,54,37,109
212,Gordon Hayward\haywago01,SF,30,CHO,44,44,1496,311,658,.473,85,205,.415,226,453,.499,.537,156,185,.843,37,221,258,181,52,14,91,74,863
213,Juan Hernangómez\hernaju01,PF,25,MIN,46,6,791,120,264,.455,50,146,.342,70,118,.593,.549,55,86,.640,40,144,184,30,18,7,21,43,345
214,Willy Hernangómez\hernawi01,C,26,NOP,40,5,671,116,206,.563,1,10,.100,115,196,.587,.566,46,68,.676,96,166,262,34,17,19,24,54,279
215,Tyler Herro\herroty01,SG,21,MIA,48,14,1472,268,627,.427,90,262,.344,178,365,.488,.499,89,110,.809,23,210,233,162,34,17,91,61,715
216,Buddy Hield\hieldbu01,SG,28,SAC,63,63,2163,359,882,.407,251,639,.393,108,243,.444,.549,81,96,.844,25,264,289,206,54,27,110,161,1050
217,George Hill\hillge01,PG,34,TOT,22,16,523,76,158,.481,25,66,.379,51,92,.554,.560,31,39,.795,15,36,51,57,15,5,21,18,208
217,George Hill\hillge01,PG,34,OKC,14,14,369,61,120,.508,22,57,.386,39,63,.619,.600,21,25,.840,8,21,29,43,12,2,12,12,165
217,George Hill\hillge01,PG,34,PHI,8,2,154,15,38,.395,3,9,.333,12,29,.414,.434,10,14,.714,7,15,22,14,3,3,9,6,43
218,Solomon Hill\hillso01,PF,29,ATL,64,14,1392,101,283,.357,64,200,.320,37,83,.446,.470,32,42,.762,40,155,195,65,46,11,40,109,298
219,Nate Hinton\hintona01,SG,21,DAL,15,0,57,9,23,.391,1,8,.125,8,15,.533,.413,4,6,.667,1,5,6,5,5,1,5,3,23
220,Jaylen Hoard\hoardja01,SF,21,OKC,12,0,194,23,52,.442,0,6,.000,23,46,.500,.442,18,27,.667,16,24,40,10,8,2,15,16,64
221,Aaron Holiday\holidaa01,PG,24,IND,61,6,1053,154,398,.387,63,170,.371,91,228,.399,.466,62,75,.827,11,67,78,105,40,11,57,89,433
222,Jrue Holiday\holidjr01,PG,30,MIL,52,49,1672,359,713,.504,94,243,.387,265,470,.564,.569,87,112,.777,65,171,236,301,90,29,113,89,899
223,Justin Holiday\holidju01,SG,31,IND,63,48,1916,221,547,.404,149,399,.373,72,148,.486,.540,56,71,.789,29,197,226,105,73,29,49,118,647
224,Rondae Hollis-Jefferson\holliro01,PF,26,POR,7,1,81,6,14,.429,0,1,.000,6,13,.462,.429,9,14,.643,10,9,19,10,2,4,2,12,21
225,Richaun Holmes\holmeri01,C,27,SAC,55,55,1625,335,520,.644,2,11,.182,333,509,.654,.646,126,159,.792,137,339,476,88,34,86,68,196,798
226,Rodney Hood\hoodro01,SF,28,TOT,52,5,914,91,253,.360,34,110,.309,57,143,.399,.427,23,27,.852,22,75,97,53,23,7,36,73,239
226,Rodney Hood\hoodro01,SF,28,POR,38,5,726,73,201,.363,25,84,.298,48,117,.410,.425,9,12,.750,18,55,73,47,20,4,31,59,180
226,Rodney Hood\hoodro01,SF,28,TOR,14,0,188,18,52,.346,9,26,.346,9,26,.346,.433,14,15,.933,4,20,24,6,3,3,5,14,59
227,Al Horford\horfoal01,C,34,OKC,28,28,782,162,360,.450,56,152,.368,106,208,.510,.528,18,22,.818,29,159,188,94,25,26,29,48,398
228,Talen Horton-Tucker\hortota01,SG,20,LAL,59,3,1153,199,439,.453,31,120,.258,168,319,.527,.489,86,110,.782,22,135,157,152,56,20,87,115,515
229,Danuel House\houseda01,SF,27,HOU,33,22,885,102,251,.406,51,144,.354,51,107,.477,.508,39,59,.661,18,106,124,61,19,16,31,63,294
230,Dwight Howard\howardw01,C,35,PHI,62,5,1074,160,273,.586,4,18,.222,156,255,.612,.593,111,192,.578,170,351,521,53,27,58,103,181,435
231,Markus Howard\howarma02,SG,21,DEN,31,0,101,13,52,.250,6,37,.162,7,15,.467,.308,1,2,.500,0,12,12,12,2,0,9,14,33
232,Kevin Huerter\huertke01,SG,22,ATL,63,47,1966,295,675,.437,131,357,.367,164,318,.516,.534,49,62,.790,35,173,208,220,78,16,75,153,770
233,Elijah Hughes\hugheel01,SF,22,UTA,15,0,55,8,26,.308,6,20,.300,2,6,.333,.423,3,4,.750,0,7,7,5,1,1,6,1,25
234,De'Andre Hunter\huntede01,SF,23,ATL,20,18,625,112,223,.502,31,87,.356,81,136,.596,.572,65,75,.867,16,86,102,42,18,10,27,53,320
235,Chandler Hutchison\hutchch01,SF,24,TOT,17,0,230,26,71,.366,4,15,.267,22,56,.393,.394,11,13,.846,5,53,58,12,5,1,16,23,67
235,Chandler Hutchison\hutchch01,SF,24,CHI,7,0,64,5,18,.278,1,3,.333,4,15,.267,.306,2,2,1.000,1,19,20,4,1,0,5,9,13
235,Chandler Hutchison\hutchch01,SF,24,WAS,10,0,166,21,53,.396,3,12,.250,18,41,.439,.425,9,11,.818,4,34,38,8,4,1,11,14,54
236,Serge Ibaka\ibakase01,C,31,LAC,39,39,919,176,347,.507,38,108,.352,138,239,.577,.562,37,45,.822,68,193,261,68,9,46,44,74,427
237,Andre Iguodala\iguodan01,SF,37,MIA,57,4,1222,89,234,.380,59,175,.337,30,59,.508,.506,24,36,.667,35,173,208,126,55,32,56,81,261
238,Ersan İlyasova\ilyaser01,PF,33,UTA,14,1,129,20,44,.455,17,36,.472,3,8,.375,.648,3,3,1.000,5,21,26,3,10,3,6,23,60
239,Joe Ingles\inglejo01,SF,33,UTA,59,22,1625,245,486,.504,167,353,.473,78,133,.586,.676,67,80,.838,26,189,215,265,38,12,101,108,724
240,Brandon Ingram\ingrabr01,SF,23,NOP,59,59,2032,503,1075,.468,139,366,.380,364,709,.513,.533,273,312,.875,34,260,294,287,40,36,152,122,1418
241,Kyrie Irving\irvinky01,PG,28,BRK,48,48,1690,487,976,.499,126,331,.381,361,645,.560,.564,185,200,.925,51,187,238,304,64,28,121,122,1285
242,Wesley Iwundu\iwundwe01,SF,26,TOT,36,4,477,31,88,.352,5,39,.128,26,49,.531,.381,24,29,.828,11,67,78,15,14,4,17,46,91
242,Wesley Iwundu\iwundwe01,SF,26,DAL,23,3,288,17,52,.327,3,23,.130,14,29,.483,.356,12,14,.857,6,38,44,10,9,3,6,26,49
242,Wesley Iwundu\iwundwe01,SF,26,NOP,13,1,189,14,36,.389,2,16,.125,12,20,.600,.417,12,15,.800,5,29,34,5,5,1,11,20,42
243,Frank Jackson\jacksfr01,PG,22,DET,35,4,615,114,245,.465,55,132,.417,59,113,.522,.578,50,63,.794,14,62,76,27,9,1,32,45,333
244,Jaren Jackson Jr.\jacksja02,C,21,MEM,5,0,109,24,56,.429,4,23,.174,20,33,.606,.464,16,21,.762,7,23,30,5,1,9,5,23,68
245,Josh Jackson\jacksjo02,SG,23,DET,58,23,1456,282,663,.425,72,237,.304,210,426,.493,.480,147,203,.724,52,181,233,129,49,42,131,166,783
246,Justin Jackson\jacksju01,SF,25,OKC,33,3,544,86,212,.406,34,111,.306,52,101,.515,.486,30,35,.857,14,57,71,51,15,2,31,31,236
247,Reggie Jackson\jacksre01,SG,30,LAC,61,39,1401,237,528,.449,106,242,.438,131,286,.458,.549,64,79,.810,23,152,175,193,38,6,69,122,644
248,Justin James\jamesju01,SF,24,SAC,29,0,195,25,54,.463,6,20,.300,19,34,.559,.519,8,18,.444,3,10,13,15,4,1,7,14,64
249,LeBron James\jamesle01,PG,36,LAL,43,43,1448,400,779,.513,101,276,.366,299,503,.594,.578,176,251,.701,25,313,338,336,45,25,162,68,1077
250,Mike James\jamesmi02,PG,30,BRK,6,0,103,13,37,.351,3,11,.273,10,26,.385,.392,8,12,.667,3,7,10,22,1,0,9,3,37
251,DaQuan Jeffries\jeffrda01,SG,23,TOT,27,2,364,35,88,.398,15,49,.306,20,39,.513,.483,6,7,.857,17,35,52,12,10,10,10,35,91
251,DaQuan Jeffries\jeffrda01,SG,23,SAC,18,2,232,24,57,.421,9,28,.321,15,29,.517,.500,6,7,.857,9,20,29,6,7,4,8,23,63
251,DaQuan Jeffries\jeffrda01,SG,23,HOU,9,0,132,11,31,.355,6,21,.286,5,10,.500,.452,0,0,,8,15,23,6,3,6,2,12,28
252,Ty Jerome\jeromty01,SG,23,OKC,31,1,746,117,264,.443,66,158,.418,51,106,.481,.568,22,30,.733,10,76,86,113,19,6,47,57,322
253,Isaiah Joe\joeis01,SG,21,PHI,35,1,312,35,106,.330,28,83,.337,7,23,.304,.462,13,18,.722,6,25,31,18,9,4,9,27,111
254,Alize Johnson\johnsal02,PF,24,BRK,15,0,181,39,65,.600,1,6,.167,38,59,.644,.608,13,13,1.000,26,63,89,14,5,4,9,15,92
255,Cameron Johnson\johnsca02,PF,24,PHO,58,11,1388,200,465,.430,116,323,.359,84,142,.592,.555,48,57,.842,32,160,192,84,33,16,40,83,564
256,James Johnson\johnsja01,PF,33,TOT,43,6,853,115,260,.442,27,103,.262,88,157,.561,.494,35,56,.625,24,114,138,82,37,39,46,101,292
256,James Johnson\johnsja01,PF,33,DAL,29,1,504,67,145,.462,15,60,.250,52,85,.612,.514,17,29,.586,14,72,86,50,24,23,27,59,166
256,James Johnson\johnsja01,PF,33,NOP,14,5,349,48,115,.417,12,43,.279,36,72,.500,.470,18,27,.667,10,42,52,32,13,16,19,42,126
257,Keldon Johnson\johnske04,SF,21,SAS,60,58,1743,301,621,.485,54,158,.342,247,463,.533,.528,124,171,.725,84,299,383,106,37,24,66,129,780
258,Stanley Johnson\johnsst04,PF,24,TOR,54,7,789,61,160,.381,32,97,.330,29,63,.460,.481,25,30,.833,22,99,121,68,41,17,43,95,179
259,Tyler Johnson\johnsty01,SG,28,BRK,36,3,627,66,170,.388,45,124,.363,21,46,.457,.521,18,21,.857,6,63,69,41,14,0,15,37,195
260,Nikola Jokić\jokicni01,C,25,DEN,64,64,2243,654,1152,.568,89,216,.412,565,936,.604,.606,282,328,.860,182,518,700,546,89,43,200,168,1679
261,Damian Jones\jonesda03,C,25,TOT,31,8,361,41,56,.732,0,1,.000,41,55,.745,.732,32,42,.762,25,48,73,14,7,15,18,58,114
261,Damian Jones\jonesda03,C,25,PHO,14,0,94,8,16,.500,0,1,.000,8,15,.533,.500,6,11,.545,7,11,18,4,1,5,6,19,22
261,Damian Jones\jonesda03,C,25,LAL,8,6,112,16,17,.941,0,0,,16,17,.941,.941,11,12,.917,8,18,26,1,1,7,5,22,43
261,Damian Jones\jonesda03,C,25,SAC,9,2,155,17,23,.739,0,0,,17,23,.739,.739,15,19,.789,10,19,29,9,5,3,7,17,49
262,Derrick Jones Jr.\jonesde02,SF,23,POR,54,42,1263,140,293,.478,43,133,.323,97,160,.606,.551,55,86,.640,76,125,201,43,36,53,29,118,378
263,Mason Jones\jonesma05,SG,22,TOT,32,1,334,52,123,.423,24,66,.364,28,57,.491,.520,40,64,.625,7,48,55,42,7,1,29,24,168
263,Mason Jones\jonesma05,SG,22,HOU,26,1,307,47,114,.412,23,64,.359,24,50,.480,.513,35,57,.614,4,47,51,39,6,1,28,22,152
263,Mason Jones\jonesma05,SG,22,PHI,6,0,27,5,9,.556,1,2,.500,4,7,.571,.611,5,7,.714,3,1,4,3,1,0,1,2,16
264,Tre Jones\jonestr01,PG,21,SAS,30,1,177,24,54,.444,2,3,.667,22,51,.431,.463,9,9,1.000,5,10,15,22,6,0,12,10,59
265,Tyus Jones\jonesty01,PG,24,MEM,61,8,1108,166,383,.433,41,131,.313,125,252,.496,.487,35,38,.921,21,105,126,236,59,6,43,28,408
266,DeAndre Jordan\jordade01,C,32,BRK,55,42,1225,190,248,.766,0,1,.000,190,247,.769,.766,43,84,.512,115,300,415,91,17,65,81,112,423
267,Cory Joseph\josepco01,PG,29,TOT,60,10,1361,184,392,.469,43,125,.344,141,267,.528,.524,69,85,.812,33,115,148,194,58,16,72,131,480
267,Cory Joseph\josepco01,PG,29,SAC,44,2,944,111,250,.444,31,94,.330,80,156,.513,.506,36,47,.766,25,74,99,108,39,9,44,98,289
267,Cory Joseph\josepco01,PG,29,DET,16,8,417,73,142,.514,12,31,.387,61,111,.550,.556,33,38,.868,8,41,49,86,19,7,28,33,191
268,Mfiondu Kabengele\kabenmf01,PF,23,TOT,31,0,172,18,50,.360,8,29,.276,10,21,.476,.440,7,9,.778,3,24,27,12,6,7,10,27,51
268,Mfiondu Kabengele\kabenmf01,PF,23,LAC,23,0,94,9,32,.281,4,18,.222,5,14,.357,.344,5,6,.833,1,13,14,5,2,3,6,18,27
268,Mfiondu Kabengele\kabenmf01,PF,23,CLE,8,0,78,9,18,.500,4,11,.364,5,7,.714,.611,2,3,.667,2,11,13,7,4,4,4,9,24
269,Frank Kaminsky\kaminfr01,C,27,PHO,39,13,567,97,203,.478,28,73,.384,69,130,.531,.547,27,47,.574,28,115,143,59,13,15,17,52,249
270,Enes Kanter\kanteen01,C,28,POR,64,35,1614,311,514,.605,0,1,.000,311,513,.606,.605,117,150,.780,262,459,721,80,32,44,74,156,739
271,Luke Kennard\kennalu01,SG,24,LAC,58,15,1137,179,374,.479,93,202,.460,86,172,.500,.603,24,29,.828,14,140,154,98,20,9,45,85,475
272,Maxi Kleber\klebima01,PF,29,DAL,48,40,1308,113,266,.425,85,205,.415,28,61,.459,.585,34,37,.919,43,207,250,64,24,34,30,104,345
273,Nathan Knight\knighna01,PF,23,ATL,30,0,244,30,85,.353,5,28,.179,25,57,.439,.382,41,49,.837,24,37,61,7,9,7,15,21,106
274,Kevin Knox\knoxke01,SF,21,NYK,40,0,457,55,141,.390,34,88,.386,21,53,.396,.511,16,20,.800,10,51,61,18,12,6,17,37,160
275,John Konchar\konchjo01,SG,24,MEM,37,0,483,48,107,.449,15,42,.357,33,65,.508,.519,20,24,.833,27,75,102,40,30,7,17,35,131
276,Furkan Korkmaz\korkmfu01,SG,23,PHI,51,10,996,163,399,.409,97,252,.385,66,147,.449,.530,59,81,.728,15,90,105,73,48,9,43,59,482
277,Luke Kornet\kornelu01,PF-C,25,TOT,25,0,245,30,72,.417,13,47,.277,17,25,.680,.507,3,6,.500,9,40,49,18,2,21,4,11,76
277,Luke Kornet\kornelu01,PF,25,CHI,13,0,94,9,27,.333,6,23,.261,3,4,.750,.444,2,4,.500,1,14,15,4,2,7,1,1,26
277,Luke Kornet\kornelu01,C,25,BOS,12,0,151,21,45,.467,7,24,.292,14,21,.667,.544,1,2,.500,8,26,34,14,0,14,3,10,50
278,Rodions Kurucs\kurucro01,SF-PF,22,TOT,21,0,125,11,32,.344,6,21,.286,5,11,.455,.438,3,4,.750,5,18,23,10,9,4,13,16,31
278,Rodions Kurucs\kurucro01,PF,22,BRK,5,0,16,1,3,.333,1,2,.500,0,1,.000,.500,0,0,,0,3,3,2,0,0,0,1,3
278,Rodions Kurucs\kurucro01,SF,22,HOU,11,0,75,5,21,.238,2,15,.133,3,6,.500,.286,1,2,.500,2,9,11,4,6,4,9,7,13
278,Rodions Kurucs\kurucro01,SF,22,MIL,5,0,34,5,8,.625,3,4,.750,2,4,.500,.813,2,2,1.000,3,6,9,4,3,0,4,8,15
279,Kyle Kuzma\kuzmaky01,SF,25,LAL,61,29,1746,300,685,.438,126,347,.363,174,338,.515,.530,57,83,.687,104,279,383,109,31,39,102,108,783
280,Anthony Lamb\lamban01,SF,23,HOU,17,0,195,20,61,.328,10,37,.270,10,24,.417,.410,8,9,.889,16,19,35,7,2,3,7,19,58
281,Jeremy Lamb\lambje01,SG,28,IND,36,8,765,120,276,.435,52,128,.406,68,148,.459,.529,71,75,.947,25,106,131,53,34,23,22,72,363
282,Romeo Langford\langfro01,SG,21,BOS,14,3,216,13,41,.317,4,15,.267,9,26,.346,.366,4,4,1.000,11,18,29,8,4,4,8,17,34
283,Zach LaVine\lavinza01,SG,25,CHI,53,53,1867,521,1030,.506,182,437,.416,339,593,.572,.594,234,276,.848,32,238,270,269,43,27,193,124,1458
284,Jake Layman\laymaja01,SF,26,MIN,42,11,602,87,175,.497,21,73,.288,66,102,.647,.557,26,37,.703,13,51,64,28,29,17,26,41,221
285,T.J. Leaf\leaftj01,PF,23,POR,2,0,13,1,2,.500,0,0,,1,2,.500,.500,0,0,,0,0,0,0,1,1,1,0,2
286,Jalen Lecque\lecquja01,PG,20,IND,4,0,12,1,9,.111,0,1,.000,1,8,.125,.111,3,3,1.000,2,3,5,2,0,0,0,0,5
287,Damion Lee\leeda03,SG,28,GSW,57,1,1079,128,274,.467,77,194,.397,51,80,.638,.608,40,44,.909,22,158,180,73,38,8,30,89,373
288,Saben Lee\leesa01,PG,21,DET,40,7,609,73,162,.451,7,16,.438,66,146,.452,.472,50,74,.676,16,64,80,135,26,10,41,63,203
289,Alex Len\lenal01,C,27,TOT,56,34,860,154,247,.623,8,25,.320,146,222,.658,.640,63,105,.600,66,155,221,45,15,57,53,112,379
289,Alex Len\lenal01,C,27,TOR,7,2,76,5,10,.500,3,6,.500,2,4,.500,.650,3,6,.500,0,11,11,3,1,6,8,10,16
289,Alex Len\lenal01,C,27,WAS,49,32,784,149,237,.629,5,19,.263,144,218,.661,.639,60,99,.606,66,144,210,42,14,51,45,102,363
290,Kawhi Leonard\leonaka01,SF,29,LAC,47,47,1612,438,848,.517,92,232,.397,346,616,.562,.571,231,263,.878,54,258,312,241,77,20,92,77,1199
291,Meyers Leonard\leoname01,C,28,MIA,3,2,29,3,7,.429,3,7,.429,0,0,,.643,1,2,.500,0,7,7,2,0,0,2,5,10
292,Caris LeVert\leverca01,SG,26,TOT,39,31,1199,288,648,.444,68,214,.318,220,434,.507,.497,106,134,.791,29,142,171,184,54,23,74,82,750
292,Caris LeVert\leverca01,SG,26,BRK,12,4,334,87,200,.435,22,63,.349,65,137,.474,.490,26,34,.765,10,42,52,72,13,6,26,20,222
292,Caris LeVert\leverca01,SG,26,IND,27,27,865,201,448,.449,46,151,.305,155,297,.522,.500,80,100,.800,19,100,119,112,41,17,48,62,528
293,Kira Lewis Jr.\lewiski01,PG,19,NOP,46,0,759,112,285,.393,36,105,.343,76,180,.422,.456,28,35,.800,9,46,55,108,33,10,29,72,288
294,Damian Lillard\lillada01,PG,30,POR,59,59,2116,517,1187,.436,238,630,.378,279,557,.501,.536,396,427,.927,29,222,251,446,55,16,184,96,1668
295,Nassir Little\littlna01,PF,20,POR,43,2,597,69,155,.445,27,78,.346,42,77,.545,.532,35,44,.795,30,89,119,22,5,13,16,50,200
296,Kevon Looney\looneke01,C,24,GSW,53,26,949,91,168,.542,4,17,.235,87,151,.576,.554,25,38,.658,100,153,253,105,20,19,33,113,211
297,Brook Lopez\lopezbr01,C,32,MIL,63,63,1720,279,568,.491,91,266,.342,188,302,.623,.571,99,116,.853,88,219,307,48,38,94,58,134,748
298,Robin Lopez\lopezro01,C,32,WAS,63,9,1210,225,355,.634,5,18,.278,220,337,.653,.641,86,121,.711,122,118,240,52,14,37,66,97,541
299,Kevin Love\loveke01,PF,32,CLE,21,21,502,82,203,.404,45,129,.349,37,74,.500,.515,33,41,.805,12,130,142,51,12,2,32,23,242
300,Kyle Lowry\lowryky01,PG,34,TOR,46,46,1601,260,596,.436,131,331,.396,129,265,.487,.546,140,160,.875,35,212,247,338,45,14,126,143,791
301,Timothé Luwawu-Cabarrot\luwawti01,SF,25,BRK,55,7,1032,127,349,.364,74,235,.315,53,114,.465,.470,35,43,.814,27,100,127,66,32,6,42,97,363
302,Trey Lyles\lylestr01,PF,25,SAS,23,9,358,43,90,.478,14,40,.350,29,50,.580,.556,15,23,.652,9,77,86,14,6,1,6,13,115
303,Will Magnay\magnawi01,C,22,NOP,1,0,3,0,1,.000,0,1,.000,0,0,,.000,0,0,,0,0,0,0,0,0,1,1,0
304,Thon Maker\makerth01,C,23,CLE,8,0,76,10,18,.556,0,2,.000,10,16,.625,.556,10,11,.909,8,10,18,4,2,4,3,7,30
305,Théo Maledon\maledth01,PG,19,OKC,59,43,1626,202,546,.370,96,278,.345,106,268,.396,.458,93,121,.769,23,174,197,207,52,9,132,123,593
306,Karim Mané\maneka01,PG,20,ORL,10,0,88,3,13,.231,1,2,.500,2,11,.182,.269,4,5,.800,1,13,14,4,0,2,3,10,11
307,Terance Mann\mannte01,SG,24,LAC,62,10,1205,160,328,.488,36,87,.414,124,241,.515,.543,68,83,.819,54,178,232,100,28,13,39,121,424
308,Nico Mannion\mannini01,PG,19,GSW,26,1,313,35,101,.347,19,53,.358,16,48,.333,.441,20,25,.800,3,33,36,58,14,1,26,26,109
309,Boban Marjanović\marjabo01,C,32,DAL,28,3,251,57,113,.504,0,6,.000,57,107,.533,.504,28,34,.824,45,77,122,9,2,6,10,29,142
310,Lauri Markkanen\markkla01,PF,23,CHI,43,25,1143,220,462,.476,100,256,.391,120,206,.583,.584,68,81,.840,31,201,232,39,20,12,44,63,608
311,Naji Marshall\marshna01,SF,23,NOP,24,4,464,43,120,.358,20,53,.377,23,67,.343,.442,39,58,.672,6,87,93,64,18,8,22,42,145
312,Caleb Martin\martica02,SF,25,CHO,47,2,690,83,219,.379,26,103,.252,57,116,.491,.438,33,53,.623,29,98,127,57,32,9,29,53,225
313,Cody Martin\martico01,SF,25,CHO,52,10,849,83,188,.441,16,58,.276,67,130,.515,.484,25,43,.581,52,109,161,86,37,12,40,52,207
314,Jeremiah Martin\martije02,PG,24,CLE,2,0,16,2,6,.333,0,2,.000,2,4,.500,.333,0,3,.000,0,0,0,2,1,0,1,1,4
315,Kelan Martin\martike03,SF,25,IND,26,0,163,25,64,.391,9,28,.321,16,36,.444,.461,7,8,.875,10,29,39,10,6,5,9,18,66
316,Kenyon Martin Jr.\martike04,SF,20,HOU,38,1,798,110,215,.512,15,51,.294,95,164,.579,.547,50,68,.735,63,118,181,22,23,35,25,67,285
317,Frank Mason III\masonfr01,PG,26,ORL,4,1,79,9,24,.375,2,5,.400,7,19,.368,.417,5,7,.714,3,9,12,12,0,0,5,7,25
318,Garrison Mathews\mathega01,SG,24,WAS,57,22,957,90,217,.415,69,179,.385,21,38,.553,.574,74,82,.902,16,66,82,25,28,6,9,96,323
319,Dakota Mathias\mathida01,SG,25,PHI,8,2,123,19,48,.396,8,26,.308,11,22,.500,.479,2,6,.333,1,6,7,13,1,3,1,7,48
320,Wesley Matthews\matthwe02,SG,34,LAL,50,7,965,71,212,.335,54,168,.321,17,44,.386,.462,30,35,.857,14,63,77,46,32,15,22,70,226
321,Tyrese Maxey\maxeyty01,SG,20,PHI,54,6,784,166,362,.459,24,87,.276,142,275,.516,.492,43,50,.860,9,72,81,90,19,9,34,65,399
322,Skylar Mays\mayssk01,SG,23,ATL,30,0,235,35,84,.417,11,34,.324,24,50,.480,.482,22,25,.880,10,21,31,23,14,0,8,14,103
323,Patrick McCaw\mccawpa01,SF,25,TOR,5,0,33,1,1,1.000,0,0,,1,1,1.000,1.000,3,3,1.000,1,2,3,4,2,0,0,6,5
324,CJ McCollum\mccolcj01,SG,29,POR,39,39,1320,337,737,.457,142,358,.397,195,379,.515,.554,88,107,.822,25,136,161,183,39,18,54,76,904
325,T.J. McConnell\mccontj01,PG,28,IND,60,2,1525,221,399,.554,13,39,.333,208,360,.578,.570,25,38,.658,42,168,210,392,107,20,111,97,480
326,Jaden McDaniels\mcdanja02,PF,20,MIN,58,24,1387,150,338,.444,66,179,.369,84,159,.528,.541,26,43,.605,49,169,218,64,33,54,43,157,392
327,Jalen McDaniels\mcdanja01,SF,23,CHO,39,10,663,99,211,.469,27,78,.346,72,133,.541,.533,34,48,.708,30,90,120,39,22,13,37,74,259
328,Doug McDermott\mcderdo01,PF,29,IND,57,20,1381,300,563,.533,94,244,.385,206,319,.646,.616,70,86,.814,58,143,201,76,18,4,45,96,764
329,Sean McDermott\mcderse01,SF,24,MEM,18,0,158,13,33,.394,5,22,.227,8,11,.727,.470,8,8,1.000,6,13,19,4,2,3,4,8,39
330,JaVale McGee\mcgeeja01,C,33,TOT,39,1,569,123,238,.517,5,21,.238,118,217,.544,.527,40,61,.656,62,133,195,34,18,45,53,97,291
330,JaVale McGee\mcgeeja01,C,33,CLE,33,1,503,112,215,.521,5,20,.250,107,195,.549,.533,36,55,.655,54,116,170,33,16,40,45,80,265
330,JaVale McGee\mcgeeja01,C,33,DEN,6,0,66,11,23,.478,0,1,.000,11,22,.500,.478,4,6,.667,8,17,25,1,2,5,8,17,26
331,Rodney McGruder\mcgruro01,SG,29,DET,16,2,194,37,70,.529,11,24,.458,26,46,.565,.607,6,8,.750,8,14,22,16,8,1,7,12,91
332,Alfonzo McKinnie\mckinal01,SF,28,LAL,35,0,222,39,75,.520,14,32,.438,25,43,.581,.613,9,17,.529,17,29,46,6,5,0,4,21,101
333,Jordan McLaughlin\mclaujo01,PG,24,MIN,45,2,841,88,217,.406,29,78,.372,59,139,.424,.472,18,24,.750,19,76,95,179,47,6,46,40,223
334,Ben McLemore\mclembe01,SG,27,TOT,45,5,757,118,315,.375,83,239,.347,35,76,.461,.506,39,53,.736,15,73,88,34,22,6,39,80,358
334,Ben McLemore\mclembe01,SG,27,HOU,32,4,537,80,224,.357,55,166,.331,25,58,.431,.480,23,32,.719,11,55,66,28,20,3,28,51,238
334,Ben McLemore\mclembe01,SG,27,LAL,13,1,220,38,91,.418,28,73,.384,10,18,.556,.571,16,21,.762,4,18,22,6,2,3,11,29,120
335,Nicolò Melli\mellini01,PF,30,TOT,38,4,464,36,110,.327,17,65,.262,19,45,.422,.405,13,19,.684,22,76,98,35,13,3,10,52,102
335,Nicolò Melli\mellini01,PF,30,NOP,22,0,241,15,59,.254,7,37,.189,8,22,.364,.314,6,7,.857,12,45,57,25,9,1,7,28,43
335,Nicolò Melli\mellini01,PF,30,DAL,16,4,223,21,51,.412,10,28,.357,11,23,.478,.510,7,12,.583,10,31,41,10,4,2,3,24,59
336,De'Anthony Melton\meltode01,PG,22,MEM,43,1,884,154,342,.450,76,177,.429,78,165,.473,.561,36,46,.783,27,116,143,115,53,26,51,74,420
337,Sam Merrill\merrisa01,SG,24,MIL,27,1,199,30,62,.484,20,41,.488,10,21,.476,.645,4,4,1.000,6,21,27,20,5,1,10,15,84
338,Chimezie Metu\metuch01,C,23,SAC,30,2,332,66,122,.541,5,17,.294,61,105,.581,.561,23,33,.697,27,52,79,21,11,15,22,48,160
339,Khris Middleton\middlkh01,SF,29,MIL,62,62,2072,466,982,.475,141,331,.426,325,651,.499,.546,189,212,.892,50,322,372,340,70,9,165,147,1262
340,Darius Miller\milleda01,SF,30,OKC,18,0,197,22,48,.458,17,42,.405,5,6,.833,.635,12,12,1.000,2,22,24,21,13,5,8,13,73
341,Patty Mills\millspa02,PG,32,SAS,60,0,1523,233,561,.415,148,394,.376,85,167,.509,.547,64,71,.901,18,88,106,148,40,3,57,73,678
342,Paul Millsap\millspa01,PF,35,DEN,51,34,1061,173,357,.485,45,129,.349,128,228,.561,.548,63,88,.716,70,176,246,86,43,35,44,102,454
343,Shake Milton\miltosh01,SG,24,PHI,56,3,1316,270,603,.448,62,177,.350,208,426,.488,.499,135,161,.839,31,98,129,168,35,14,96,119,737
344,Donovan Mitchell\mitchdo01,PG,24,UTA,53,53,1771,478,1091,.438,178,461,.386,300,630,.476,.520,267,316,.845,50,185,235,277,52,15,147,117,1401
345,Adam Mokoka\mokokad01,SG,22,CHI,13,0,54,7,18,.389,1,10,.100,6,8,.750,.417,0,1,.000,1,4,5,5,2,1,4,5,15
346,Malik Monk\monkma01,SG,22,CHO,34,0,744,156,339,.460,75,174,.431,81,165,.491,.571,54,66,.818,13,74,87,68,18,4,48,43,441
347,E'Twaun Moore\mooreet01,SG,31,PHO,24,1,348,43,102,.422,8,29,.276,35,73,.479,.461,8,10,.800,13,29,42,35,14,4,18,31,102
348,Ja Morant\moranja01,PG,21,MEM,55,55,1764,380,836,.455,61,201,.303,319,635,.502,.491,242,328,.738,50,163,213,401,51,11,171,78,1063
349,Juwan Morgan\morgaju01,PF,23,UTA,25,0,128,13,26,.500,4,13,.308,9,13,.692,.577,3,7,.429,9,17,26,9,4,1,3,20,33
350,Marcus Morris\morrima03,PF,31,LAC,51,23,1354,250,536,.466,129,276,.467,121,260,.465,.587,61,75,.813,32,180,212,54,32,13,46,109,690
351,Markieff Morris\morrima02,PF,31,LAL,56,26,1127,145,350,.414,62,199,.312,83,151,.550,.503,33,44,.750,45,204,249,64,20,19,51,98,385
352,Monte Morris\morrimo01,PG,25,DEN,44,13,1151,174,365,.477,49,130,.377,125,235,.532,.544,56,71,.789,11,84,95,141,31,13,32,45,453
353,Mychal Mulder\muldemy01,PG,26,GSW,52,5,586,88,195,.451,61,157,.389,27,38,.711,.608,11,19,.579,4,45,49,21,9,9,12,42,248
354,Dejounte Murray\murrade01,PG,24,SAS,59,59,1893,389,858,.453,61,181,.337,328,677,.484,.489,97,120,.808,50,372,422,318,93,6,101,126,936
355,Jamal Murray\murraja01,PG,23,DEN,48,48,1704,378,792,.477,129,316,.408,249,476,.523,.559,133,153,.869,37,157,194,231,64,13,108,95,1018
356,Mike Muscala\muscami01,C,29,OKC,35,0,645,119,267,.446,68,184,.370,51,83,.614,.573,33,36,.917,19,113,132,28,8,11,21,54,339
357,Sviatoslav Mykhailiuk\mykhasv01,SF-SG,23,TOT,61,14,1208,178,438,.406,95,283,.336,83,155,.535,.515,37,48,.771,23,128,151,98,43,11,82,55,488
357,Sviatoslav Mykhailiuk\mykhasv01,SF,23,DET,36,5,634,84,223,.377,57,171,.333,27,52,.519,.504,24,30,.800,11,63,74,57,27,6,39,33,249
357,Sviatoslav Mykhailiuk\mykhasv01,SG,23,OKC,25,9,574,94,215,.437,38,112,.339,56,103,.544,.526,13,18,.722,12,65,77,41,16,5,43,22,239
358,Abdel Nader\naderab01,SF,27,PHO,24,0,355,57,116,.491,18,43,.419,39,73,.534,.569,28,37,.757,7,55,62,19,10,9,19,34,160
359,Larry Nance Jr.\nancela02,PF,28,CLE,35,27,1091,128,272,.471,41,114,.360,87,158,.551,.546,30,49,.612,54,181,235,107,61,17,55,72,327
360,Aaron Nesmith\nesmiaa01,SF,21,BOS,39,0,535,60,137,.438,34,89,.382,26,48,.542,.562,14,20,.700,22,75,97,14,13,9,20,65,168
361,Raul Neto\netora01,PG,28,WAS,58,16,1231,186,398,.467,57,148,.385,129,250,.516,.539,59,69,.855,25,119,144,127,65,4,48,92,488
362,Georges Niang\niangge01,PF,27,UTA,64,4,971,143,335,.427,101,245,.412,42,90,.467,.578,13,13,1.000,26,131,157,50,18,8,46,100,400
363,Zeke Nnaji\nnajize01,PF,20,DEN,40,1,363,45,95,.474,20,53,.377,25,42,.595,.579,12,15,.800,13,45,58,8,6,4,7,28,122
364,Nerlens Noel\noelne01,C,26,NYK,57,34,1352,123,202,.609,0,3,.000,123,199,.618,.609,43,61,.705,130,236,366,45,60,123,61,153,289
365,Jaylen Nowell\nowelja01,SG,21,MIN,38,0,714,136,318,.428,47,139,.338,89,179,.497,.502,42,51,.824,18,71,89,59,21,10,27,68,361
366,Frank Ntilikina\ntilila01,PG,22,NYK,26,4,266,24,65,.369,18,38,.474,6,27,.222,.508,8,16,.500,5,20,25,15,15,2,10,38,74
367,Kendrick Nunn\nunnke01,PG,25,MIA,50,38,1473,278,582,.478,112,289,.388,166,293,.567,.574,48,52,.923,18,141,159,137,49,12,74,98,716
368,James Nunnally\nunnaja01,SF,30,NOP,4,0,25,4,8,.500,3,7,.429,1,1,1.000,.688,0,0,,1,3,4,0,0,0,1,0,11
369,Jusuf Nurkić\nurkiju01,C,26,POR,29,29,677,126,249,.506,10,26,.385,116,223,.520,.526,56,86,.651,62,186,248,94,28,26,59,83,318
370,David Nwaba\nwabada01,SF,28,HOU,30,9,679,106,218,.486,17,63,.270,89,155,.574,.525,47,68,.691,40,78,118,31,30,21,17,60,276
371,Jordan Nwora\nworajo01,SF,22,MIL,26,2,230,48,109,.440,24,53,.453,24,56,.429,.550,17,21,.810,4,40,44,7,14,5,20,19,137
372,Royce O'Neale\onealro01,SF,27,UTA,63,63,2005,153,345,.443,95,246,.386,58,99,.586,.581,36,42,.857,76,366,442,161,49,29,72,168,437
373,Semi Ojeleye\ojelese01,PF,26,BOS,51,13,884,81,204,.397,56,147,.381,25,57,.439,.534,24,32,.750,28,106,134,35,15,0,20,54,242
374,Jahlil Okafor\okafoja01,C,25,DET,20,0,228,39,64,.609,2,6,.333,37,58,.638,.625,8,12,.667,13,28,41,12,4,4,12,24,88
375,Chuma Okeke\okekech01,PF,22,ORL,45,19,1133,135,324,.417,49,141,.348,86,183,.470,.492,30,40,.750,42,139,181,101,48,22,38,48,349
376,Josh Okogie\okogijo01,SG,22,MIN,52,36,1090,93,233,.399,27,99,.273,66,134,.493,.457,77,95,.811,54,86,140,58,49,23,36,111,290
377,Onyeka Okongwu\okongon01,C,20,ATL,43,3,500,71,114,.623,0,3,.000,71,111,.640,.623,30,47,.638,44,82,126,10,18,28,23,90,172
378,Isaac Okoro\okorois01,SG,20,CLE,59,59,1875,185,439,.421,49,172,.285,136,267,.509,.477,89,122,.730,60,110,170,102,59,23,77,163,508
379,KZ Okpala\okpalkz01,PF,21,MIA,33,9,389,29,85,.341,12,48,.250,17,37,.459,.412,3,10,.300,18,42,60,16,8,8,13,53,73
380,Victor Oladipo\oladivi01,SG,28,TOT,33,33,1080,235,576,.408,78,239,.326,157,337,.466,.476,104,138,.754,12,148,160,151,46,14,83,81,652
380,Victor Oladipo\oladivi01,SG,28,IND,9,9,300,64,152,.421,25,69,.362,39,83,.470,.503,27,37,.730,1,50,51,38,15,2,18,23,180
380,Victor Oladipo\oladivi01,SG,28,HOU,20,20,669,155,381,.407,49,153,.320,106,228,.465,.471,65,83,.783,8,87,95,99,24,10,51,45,424
380,Victor Oladipo\oladivi01,SG,28,MIA,4,4,111,16,43,.372,4,17,.235,12,26,.462,.419,12,18,.667,3,11,14,14,7,2,14,13,48
381,Kelly Olynyk\olynyke01,C-PF,29,TOT,64,56,1817,301,618,.487,114,341,.334,187,277,.675,.579,98,118,.831,77,360,437,159,68,37,108,184,814
381,Kelly Olynyk\olynyke01,C,29,MIA,43,38,1157,162,376,.431,77,243,.317,85,133,.639,.533,31,40,.775,44,217,261,91,40,26,55,123,432
381,Kelly Olynyk\olynyke01,PF,29,HOU,21,18,660,139,242,.574,37,98,.378,102,144,.708,.651,67,78,.859,33,143,176,68,28,11,53,61,382
382,Miye Oni\onimi01,SG,23,UTA,46,0,418,31,87,.356,26,77,.338,5,10,.500,.506,5,6,.833,19,54,73,21,7,8,15,53,93
383,Cedi Osman\osmande01,SF,25,CLE,54,21,1344,192,522,.368,88,292,.301,104,230,.452,.452,68,87,.782,36,145,181,152,49,9,64,104,540
384,Daniel Oturu\oturuda01,C,21,LAC,25,0,103,15,28,.536,0,1,.000,15,27,.556,.536,5,8,.625,11,17,28,7,1,3,5,14,35
385,Kelly Oubre Jr.\oubreke01,SF,25,GSW,55,50,1687,318,724,.439,90,285,.316,228,439,.519,.501,123,177,.695,82,247,329,73,57,42,70,121,849
386,Jabari Parker\parkeja01,PF,25,TOT,9,0,103,18,33,.545,0,5,.000,18,28,.643,.545,3,4,.750,7,18,25,7,1,4,7,8,39
386,Jabari Parker\parkeja01,PF,25,SAC,3,0,27,4,7,.571,0,1,.000,4,6,.667,.571,0,0,,1,5,6,1,0,1,3,4,8
386,Jabari Parker\parkeja01,PF,25,BOS,6,0,76,14,26,.538,0,4,.000,14,22,.636,.538,3,4,.750,6,13,19,6,1,3,4,4,31
387,Eric Paschall\pascher01,PF,24,GSW,39,2,676,144,293,.491,17,53,.321,127,240,.529,.520,64,89,.719,27,97,124,51,12,7,41,65,369
388,Anžejs Pasečņiks\pasecan01,C,25,WAS,1,0,6,0,1,.000,0,1,.000,0,0,,.000,0,0,,1,0,1,1,0,0,5,2,0
389,Patrick Patterson\pattepa01,PF,31,LAC,36,4,510,63,145,.434,36,99,.364,27,46,.587,.559,12,16,.750,16,52,68,22,13,8,11,44,174
390,Justin Patton\pattoju01,C,23,HOU,13,6,247,29,70,.414,9,34,.265,20,36,.556,.479,3,4,.750,14,35,49,14,12,14,4,34,70
391,Chris Paul\paulch01,PG,35,PHO,63,63,1986,389,787,.494,91,237,.384,298,550,.542,.552,152,163,.933,24,262,286,552,88,15,143,146,1021
392,Cameron Payne\payneca01,PG,26,PHO,52,0,907,149,322,.463,55,135,.407,94,187,.503,.548,40,46,.870,15,109,124,183,30,13,54,86,393
393,Elfrid Payton\paytoel01,PG,26,NYK,55,55,1364,257,581,.442,28,94,.298,229,487,.470,.466,70,102,.686,63,130,193,187,43,9,93,100,612
394,Gary Payton II\paytoga02,PG,28,GSW,10,0,40,10,13,.769,2,4,.500,8,9,.889,.846,3,4,.750,2,9,11,1,6,1,1,8,25
395,Norvel Pelle\pelleno01,C,27,TOT,10,0,63,6,13,.462,0,0,,6,13,.462,.462,4,6,.667,6,10,16,1,1,6,3,12,16
395,Norvel Pelle\pelleno01,C,27,BRK,3,0,28,3,7,.429,0,0,,3,7,.429,.429,0,0,,3,4,7,0,0,3,3,9,6
395,Norvel Pelle\pelleno01,C,27,SAC,1,0,4,0,1,.000,0,0,,0,1,.000,.000,3,4,.750,1,0,1,1,0,0,0,1,3
395,Norvel Pelle\pelleno01,C,27,NYK,6,0,31,3,5,.600,0,0,,3,5,.600,.600,1,2,.500,2,6,8,0,1,3,0,2,7
396,Reggie Perry\perryre01,PF,20,BRK,23,0,203,32,76,.421,4,21,.190,28,55,.509,.447,10,13,.769,26,43,69,14,6,6,14,36,78
397,Theo Pinson\pinsoth01,SG,25,NYK,16,0,33,1,9,.111,0,8,.000,1,1,1.000,.111,0,0,,0,4,4,1,0,0,1,4,2
398,Mason Plumlee\plumlma01,C,30,DET,55,55,1474,228,372,.613,0,7,.000,228,365,.625,.613,113,169,.669,142,371,513,197,42,48,104,182,569
399,Jakob Poeltl\poeltja01,C,25,SAS,61,43,1624,232,368,.630,0,0,,232,368,.630,.630,59,117,.504,200,287,487,113,40,107,80,153,523
400,Vincent Poirier\poirivi01,C,27,PHI,10,0,39,3,12,.250,0,1,.000,3,11,.273,.250,2,6,.333,6,8,14,2,0,3,4,8,8
401,Aleksej Pokusevski\pokusal01,PF,19,OKC,41,24,959,117,360,.325,48,185,.259,69,175,.394,.392,27,34,.794,29,161,190,87,19,41,80,52,309
402,Jordan Poole\poolejo01,SG,21,GSW,43,6,800,159,382,.416,75,217,.346,84,165,.509,.514,76,86,.884,9,62,71,85,24,7,41,70,469
403,Jontay Porter\portejo01,PF,21,MEM,9,0,27,3,10,.300,2,7,.286,1,3,.333,.400,3,3,1.000,2,8,10,1,2,0,5,6,11
404,Kevin Porter Jr.\porteke02,SG,20,HOU,25,22,812,150,354,.424,48,156,.308,102,198,.515,.492,67,90,.744,20,78,98,159,19,8,89,59,415
405,Michael Porter Jr.\portemi01,SF,22,DEN,54,47,1702,389,717,.543,145,327,.443,244,390,.626,.644,96,123,.780,86,322,408,60,32,54,64,111,1019
406,Otto Porter\porteot01,SF-PF,27,TOT,28,6,606,98,227,.432,39,104,.375,59,123,.480,.518,36,42,.857,28,124,152,55,16,4,25,41,271
406,Otto Porter\porteot01,SF,27,CHI,25,6,540,89,202,.441,38,95,.400,51,107,.477,.535,31,37,.838,28,110,138,50,12,4,25,37,247
406,Otto Porter\porteot01,PF,27,ORL,3,0,66,9,25,.360,1,9,.111,8,16,.500,.380,5,5,1.000,0,14,14,5,4,0,0,4,24
407,Bobby Portis\portibo01,C,25,MIL,59,7,1251,281,532,.528,68,142,.479,213,390,.546,.592,45,60,.750,106,315,421,67,47,23,51,108,675
408,Kristaps Porziņģis\porzikr01,C,25,DAL,40,40,1245,303,640,.473,88,243,.362,215,397,.542,.542,113,133,.850,77,285,362,64,19,57,51,106,807
409,Dwight Powell\poweldw01,C,29,DAL,50,16,765,95,162,.586,5,21,.238,90,141,.638,.602,81,106,.764,62,119,181,37,30,19,32,109,276
410,Norman Powell\powelno01,SG-SF,27,TOT,62,51,1956,399,827,.482,154,377,.408,245,450,.544,.576,213,246,.866,37,149,186,117,76,16,111,144,1165
410,Norman Powell\powelno01,SG,27,TOR,42,31,1277,282,566,.498,118,269,.439,164,297,.552,.602,141,163,.865,19,107,126,77,47,8,77,98,823
410,Norman Powell\powelno01,SF,27,POR,20,20,679,117,261,.448,36,108,.333,81,153,.529,.517,72,83,.867,18,42,60,40,29,8,34,46,342
411,Taurean Prince\princta02,PF,26,TOT,41,10,905,131,327,.401,62,155,.400,69,172,.401,.495,65,76,.855,19,123,142,76,28,23,47,75,389
411,Taurean Prince\princta02,PF,26,BRK,12,4,218,30,74,.405,13,37,.351,17,37,.459,.493,24,27,.889,2,32,34,7,8,8,11,21,97
411,Taurean Prince\princta02,PF,26,CLE,29,6,687,101,253,.399,49,118,.415,52,135,.385,.496,41,49,.837,17,91,108,69,20,15,36,54,292
412,Payton Pritchard\pritcpa01,SG,23,BOS,59,2,1142,164,363,.452,88,211,.417,76,152,.500,.573,39,43,.907,31,107,138,107,32,9,51,96,455
413,Immanuel Quickley\quickim01,PG,21,NYK,59,3,1153,217,547,.397,111,284,.391,106,263,.403,.498,145,162,.895,24,106,130,126,29,12,54,106,690
414,Jahmi'us Ramsey\ramseja01,SG,19,SAC,7,0,26,6,12,.500,2,7,.286,4,5,.800,.583,0,0,,1,4,5,3,1,1,1,1,14
415,Chasson Randle\randlch01,PG,27,ORL,33,5,638,65,173,.376,35,98,.357,30,75,.400,.477,22,29,.759,4,54,58,61,16,2,37,49,187
416,Julius Randle\randlju01,PF,26,NYK,63,63,2356,538,1159,.464,143,339,.422,395,820,.482,.526,304,376,.809,79,571,650,373,60,16,214,198,1523
417,Cam Reddish\reddica01,SF,21,ATL,26,21,750,96,263,.365,33,126,.262,63,137,.460,.428,67,82,.817,22,82,104,35,33,9,34,68,292
418,J.J. Redick\redicjj01,SG,36,TOT,41,0,702,104,258,.403,64,170,.376,40,88,.455,.527,47,50,.940,4,59,63,50,11,3,34,47,319
418,J.J. Redick\redicjj01,SG,36,NOP,31,0,576,87,214,.407,51,140,.364,36,74,.486,.526,45,47,.957,3,49,52,40,9,2,25,37,270
418,J.J. Redick\redicjj01,SG,36,DAL,10,0,126,17,44,.386,13,30,.433,4,14,.286,.534,2,3,.667,1,10,11,10,2,1,9,10,49
419,Paul Reed\reedpa01,PF,21,PHI,21,0,136,30,56,.536,0,6,.000,30,50,.600,.536,1,4,.250,20,23,43,7,7,12,10,22,61
420,Naz Reid\reidna01,C,21,MIN,63,15,1207,270,519,.520,55,154,.357,215,365,.589,.573,108,153,.706,69,213,282,64,31,67,62,160,703
421,Cameron Reynolds\reynoca01,SF,25,SAS,3,0,6,1,2,.500,0,0,,1,2,.500,.500,0,0,,0,0,0,0,0,0,0,0,2
422,Nick Richards\richani01,PF,23,CHO,17,0,61,4,8,.500,0,1,.000,4,7,.571,.500,7,11,.636,2,7,9,2,0,0,3,7,15
423,Josh Richardson\richajo01,SG,27,DAL,51,51,1605,225,534,.421,76,240,.317,149,294,.507,.493,91,100,.910,43,135,178,139,48,22,72,121,617
424,Grant Riller\rillegr01,PG,23,CHO,5,0,21,6,9,.667,2,4,.500,4,5,.800,.778,0,0,,0,0,0,3,1,0,1,0,14
425,Austin Rivers\riverau01,SG,28,TOT,28,2,615,73,180,.406,34,105,.324,39,75,.520,.500,14,19,.737,6,54,60,58,20,2,25,45,194
425,Austin Rivers\riverau01,SG,28,NYK,21,2,442,58,135,.430,28,77,.364,30,58,.517,.533,10,14,.714,5,42,47,42,12,0,22,32,154
425,Austin Rivers\riverau01,SG,28,DEN,7,0,173,15,45,.333,6,28,.214,9,17,.529,.400,4,5,.800,1,12,13,16,8,2,3,13,40
426,Andre Roberson\roberan03,SG,29,BRK,5,0,63,2,14,.143,1,8,.125,1,6,.167,.179,1,2,.500,7,8,15,4,3,1,2,4,6
427,Duncan Robinson\robindu01,SF,26,MIA,65,65,2063,284,649,.438,225,556,.405,59,93,.634,.611,52,64,.813,5,223,228,113,35,16,72,164,845
428,Glenn Robinson III\robingl02,SF,27,SAC,23,2,369,42,99,.424,16,44,.364,26,55,.473,.505,21,23,.913,11,34,45,20,4,3,11,23,121
429,Jerome Robinson\robinje01,SG,23,WAS,17,6,305,28,95,.295,11,42,.262,17,53,.321,.353,16,20,.800,4,34,38,25,12,6,19,31,83
430,Justin Robinson\robinju01,PG,23,OKC,9,0,88,7,21,.333,4,14,.286,3,7,.429,.429,3,5,.600,1,6,7,9,3,0,2,10,21
431,Mitchell Robinson\robinmi01,C,22,NYK,31,29,853,115,176,.653,0,0,,115,176,.653,.653,26,53,.491,113,139,252,17,35,45,26,86,256
432,Isaiah Roby\robyis01,PF,22,OKC,54,27,1269,188,383,.491,31,95,.326,157,288,.545,.531,82,110,.745,85,228,313,101,48,34,101,145,489
433,Rajon Rondo\rondora01,PG,34,TOT,39,2,646,80,184,.435,28,75,.373,52,109,.477,.511,10,11,.909,14,75,89,159,31,4,60,50,198
433,Rajon Rondo\rondora01,PG,34,ATL,27,2,402,44,110,.400,17,45,.378,27,65,.415,.477,1,2,.500,4,51,55,95,19,2,39,25,106
433,Rajon Rondo\rondora01,PG,34,LAC,12,0,244,36,74,.486,11,30,.367,25,44,.568,.561,9,9,1.000,10,24,34,64,12,2,21,25,92
434,Derrick Rose\rosede01,PG,32,TOT,43,3,1077,233,515,.452,40,109,.367,193,406,.475,.491,98,115,.852,16,88,104,179,44,18,64,49,604
434,Derrick Rose\rosede01,PG,32,DET,15,0,342,79,184,.429,13,39,.333,66,145,.455,.465,42,50,.840,6,23,29,63,18,4,29,17,213
434,Derrick Rose\rosede01,PG,32,NYK,28,3,735,154,331,.465,27,70,.386,127,261,.487,.506,56,65,.862,10,65,75,116,26,14,35,32,391
435,Terrence Ross\rosste01,SG,29,ORL,46,2,1347,254,616,.412,89,264,.337,165,352,.469,.485,120,138,.870,15,143,158,108,47,21,74,88,717
436,Terry Rozier\roziete01,SG,26,CHO,61,61,2077,449,985,.456,201,506,.397,248,479,.518,.558,141,170,.829,37,221,258,251,74,25,113,106,1240
437,Ricky Rubio\rubiori01,PG,30,MIN,61,46,1595,168,440,.382,57,183,.311,111,257,.432,.447,122,141,.865,24,174,198,397,91,3,103,127,515
438,D'Angelo Russell\russeda01,PG,24,MIN,35,19,977,238,547,.435,100,258,.388,138,289,.478,.527,88,113,.779,11,75,86,191,36,14,97,62,664
439,Domantas Sabonis\sabondo01,PF,24,IND,54,54,1922,407,777,.524,44,142,.310,363,635,.572,.552,221,303,.729,134,500,634,333,61,29,183,181,1079
440,Luka Šamanić\samanlu01,PF,21,SAS,28,4,265,37,83,.446,9,37,.243,28,46,.609,.500,12,24,.500,14,45,59,13,7,7,16,40,95
441,JaKarr Sampson\sampsja02,PF,27,IND,25,4,261,40,85,.471,3,12,.250,37,73,.507,.488,15,25,.600,22,44,66,3,2,13,14,47,98
442,Dario Šarić\saricda01,C,26,PHO,43,1,756,137,301,.455,43,122,.352,94,179,.525,.527,71,82,.866,42,126,168,59,25,4,52,83,388
443,Tomáš Satoranský\satorto01,SG,29,CHI,52,18,1199,155,301,.515,40,108,.370,115,193,.596,.581,64,74,.865,27,102,129,247,40,12,90,82,414
444,Dennis Schröder\schrode01,SG,27,LAL,59,59,1901,324,740,.438,67,200,.335,257,540,.476,.483,200,237,.844,30,177,207,343,68,13,160,155,915
445,Mike Scott\scottmi01,PF,32,PHI,43,11,735,65,175,.371,46,133,.346,19,42,.452,.503,8,12,.667,9,98,107,30,23,7,18,64,184
446,Collin Sexton\sextoco01,SG,22,CLE,52,52,1854,464,961,.483,88,233,.378,376,728,.516,.529,254,312,.814,50,113,163,215,58,9,142,139,1270
447,Landry Shamet\shamela01,SG,23,BRK,54,9,1220,170,409,.416,117,298,.393,53,111,.477,.559,62,72,.861,9,92,101,84,27,8,46,83,519
448,Iman Shumpert\shumpim01,SG,30,BRK,2,0,11,1,4,.250,0,3,.000,1,1,1.000,.250,0,0,,1,0,1,0,1,0,1,0,2
449,Pascal Siakam\siakapa01,PF,26,TOR,53,53,1892,402,888,.453,70,231,.303,332,657,.505,.492,236,282,.837,91,293,384,237,60,37,120,169,1110
450,Chris Silva\silvach01,PF,24,TOT,15,0,92,10,16,.625,1,1,1.000,9,15,.600,.656,11,15,.733,7,20,27,6,1,6,10,24,32
450,Chris Silva\silvach01,PF,24,MIA,11,0,83,9,13,.692,1,1,1.000,8,12,.667,.731,11,15,.733,7,18,25,6,1,5,9,20,30
450,Chris Silva\silvach01,PF,24,SAC,4,0,9,1,3,.333,0,0,,1,3,.333,.333,0,0,,0,2,2,0,0,1,1,4,2
451,Ben Simmons\simmobe01,PG,24,PHI,52,52,1697,293,530,.553,3,10,.300,290,520,.558,.556,166,274,.606,86,300,386,361,85,34,163,156,755
452,Anfernee Simons\simonan01,SG,21,POR,56,0,934,153,359,.426,112,254,.441,41,105,.390,.582,40,51,.784,12,107,119,82,17,7,38,81,458
453,Deividas Sirvydis\sirvyde01,SG,20,DET,16,0,49,5,18,.278,4,14,.286,1,4,.250,.389,3,4,.750,0,11,11,2,1,0,3,4,17
454,Alen Smailagić\smailal01,PF,20,GSW,11,1,50,7,18,.389,2,5,.400,5,13,.385,.444,1,4,.250,3,8,11,3,2,4,1,7,17
455,Marcus Smart\smartma01,PG,26,BOS,44,41,1453,189,473,.400,89,265,.336,100,208,.481,.494,127,159,.799,34,118,152,250,67,21,82,113,594
456,Dennis Smith Jr.\smithde03,PG,23,TOT,23,9,420,58,145,.400,19,58,.328,39,87,.448,.466,19,26,.731,12,43,55,77,23,14,26,37,154
456,Dennis Smith Jr.\smithde03,PG,23,NYK,3,0,28,2,10,.200,0,4,.000,2,6,.333,.200,5,6,.833,0,2,2,3,3,0,1,4,9
456,Dennis Smith Jr.\smithde03,PG,23,DET,20,9,392,56,135,.415,19,54,.352,37,81,.457,.485,14,20,.700,12,41,53,74,20,14,25,33,145
457,Ish Smith\smithis01,PG,32,WAS,36,1,738,97,229,.424,14,38,.368,83,191,.435,.454,16,29,.552,17,99,116,148,26,11,36,51,224
458,Jalen Smith\smithja04,PF,20,PHO,23,0,94,14,33,.424,3,12,.250,11,21,.524,.470,1,3,.333,6,14,20,2,1,2,5,10,32
459,Tony Snell\snellto01,SG,29,ATL,42,20,884,79,154,.513,59,104,.567,20,50,.400,.705,11,11,1.000,16,82,98,55,11,11,19,65,228
460,Ray Spalding\spaldra01,C,23,HOU,2,0,19,2,4,.500,0,1,.000,2,3,.667,.500,0,2,.000,2,2,4,0,0,2,3,3,4
461,Cassius Stanley\stanlca01,SG,21,IND,20,0,67,11,33,.333,2,9,.222,9,24,.375,.364,6,7,.857,6,10,16,1,0,2,1,11,30
462,Lamar Stevens\stevela01,PF,23,CLE,40,0,499,62,136,.456,4,25,.160,58,111,.523,.471,37,51,.725,24,72,96,25,17,13,23,53,165
463,Isaiah Stewart\stewais01,C,19,DET,62,9,1281,201,349,.576,15,37,.405,186,312,.596,.597,53,77,.688,149,261,410,52,34,75,61,165,470
464,Max Strus\strusma01,SF,24,MIA,35,0,452,75,166,.452,44,132,.333,31,34,.912,.584,11,18,.611,5,31,36,21,10,1,7,41,205
465,Edmond Sumner\sumneed01,SG,25,IND,50,21,802,139,263,.529,33,85,.388,106,178,.596,.591,63,78,.808,17,71,88,46,31,10,46,81,374
466,Jae'Sean Tate\tateja01,SF,25,HOU,65,53,1909,292,569,.513,52,175,.297,240,394,.609,.559,90,129,.698,124,224,348,152,84,34,86,206,726
467,Jayson Tatum\tatumja01,SF,22,BOS,58,58,2082,550,1197,.459,171,435,.393,379,762,.497,.531,268,307,.873,44,383,427,255,66,24,157,108,1539
468,Jeff Teague\teaguje01,PG,32,TOT,49,6,861,107,252,.425,30,74,.405,77,178,.433,.484,77,90,.856,13,68,81,118,28,10,54,54,321
468,Jeff Teague\teaguje01,PG,32,BOS,34,5,616,78,188,.415,26,56,.464,52,132,.394,.484,51,61,.836,10,47,57,73,26,7,39,43,233
468,Jeff Teague\teaguje01,PG,32,MIL,15,1,245,29,64,.453,4,18,.222,25,46,.543,.484,26,29,.897,3,21,24,45,2,3,15,11,88
469,Garrett Temple\templga01,SG,34,CHI,48,22,1305,140,332,.422,60,178,.337,80,154,.519,.512,35,43,.814,23,109,132,109,38,22,52,110,375
470,Tyrell Terry\terryty01,PG,20,DAL,11,0,56,5,16,.313,0,7,.000,5,9,.556,.313,1,3,.333,0,6,6,6,5,0,2,2,11
471,Daniel Theis\theisda01,C,28,TOT,61,47,1485,237,435,.545,44,143,.308,193,292,.661,.595,67,102,.657,82,245,327,101,36,54,61,154,585
471,Daniel Theis\theisda01,C,28,BOS,42,37,1027,159,288,.552,33,95,.347,126,193,.653,.609,46,67,.687,54,166,220,67,25,43,41,120,397
471,Daniel Theis\theisda01,C,28,CHI,19,10,458,78,147,.531,11,48,.229,67,99,.677,.568,21,35,.600,28,79,107,34,11,11,20,34,188
472,Brodric Thomas\thomabr01,SG,24,TOT,24,1,215,20,65,.308,10,37,.270,10,28,.357,.385,19,27,.704,5,20,25,18,8,7,17,23,69
472,Brodric Thomas\thomabr01,SG,24,HOU,4,0,24,2,7,.286,1,6,.167,1,1,1.000,.357,5,7,.714,1,3,4,4,1,1,4,5,10
472,Brodric Thomas\thomabr01,SG,24,CLE,20,1,191,18,58,.310,9,31,.290,9,27,.333,.388,14,20,.700,4,17,21,14,7,6,13,18,59
473,Isaiah Thomas\thomais02,PG,31,NOP,3,0,48,9,27,.333,3,12,.250,6,15,.400,.389,2,2,1.000,1,3,4,5,1,0,6,3,23
474,Matt Thomas\thomama02,SG,26,TOT,38,0,285,45,108,.417,25,67,.373,20,41,.488,.532,9,10,.900,5,29,34,15,3,0,13,15,124
474,Matt Thomas\thomama02,SG,26,TOR,26,0,192,24,62,.387,17,41,.415,7,21,.333,.524,6,7,.857,3,18,21,9,2,0,6,10,71
474,Matt Thomas\thomama02,SG,26,UTA,12,0,93,21,46,.457,8,26,.308,13,20,.650,.543,3,3,1.000,2,11,13,6,1,0,7,5,53
475,Tristan Thompson\thomptr01,PF,29,BOS,50,40,1171,159,307,.518,0,3,.000,159,304,.523,.518,69,114,.605,158,249,407,64,20,30,57,108,387
476,Sindarius Thornwell\thornsi01,SG,26,NOP,14,1,73,7,21,.333,3,9,.333,4,12,.333,.405,0,2,.000,1,4,5,4,5,1,4,3,17
477,Matisse Thybulle\thybuma01,SG,23,PHI,61,7,1223,96,228,.421,40,133,.301,56,95,.589,.509,8,18,.444,30,89,119,60,96,64,28,122,240
478,Killian Tillie\tilliki02,C,22,MEM,16,0,129,13,42,.310,6,26,.231,7,16,.438,.381,6,7,.857,6,11,17,5,5,7,1,17,38
479,Xavier Tillman Sr.\tillmxa01,PF,22,MEM,52,10,976,150,271,.554,20,60,.333,130,211,.616,.590,32,48,.667,66,164,230,67,42,29,35,110,352
480,Anthony Tolliver\tollian01,PF,35,PHI,6,0,65,1,10,.100,1,7,.143,0,3,.000,.150,5,6,.833,3,5,8,2,3,2,3,6,8
481,Obi Toppin\toppiob01,PF,22,NYK,54,0,602,89,184,.484,21,74,.284,68,110,.618,.541,19,26,.731,23,99,122,25,14,12,23,49,218
482,Juan Toscano-Anderson\toscaju01,SG,27,GSW,45,15,865,94,161,.584,27,65,.415,67,96,.698,.668,20,29,.690,26,155,181,108,32,22,48,90,235
483,Axel Toupane\toupaax01,SF,28,MIL,8,1,61,4,11,.364,1,2,.500,3,9,.333,.409,5,7,.714,0,6,6,4,2,3,0,6,14
484,Karl-Anthony Towns\townska01,C,25,MIN,43,43,1474,369,757,.487,106,269,.394,263,488,.539,.557,224,260,.862,112,356,468,196,32,55,140,157,1068
485,Gary Trent Jr.\trentga02,SG,22,TOT,55,35,1699,304,733,.415,157,404,.389,147,329,.447,.522,71,91,.780,22,117,139,77,54,9,41,84,836
485,Gary Trent Jr.\trentga02,SG,22,POR,41,23,1262,217,524,.414,121,305,.397,96,219,.438,.530,58,75,.773,21,70,91,58,37,6,31,63,613
485,Gary Trent Jr.\trentga02,SG,22,TOR,14,12,437,87,209,.416,36,99,.364,51,110,.464,.502,13,16,.813,1,47,48,19,17,3,10,21,223
486,P.J. Tucker\tuckepj01,PF,35,TOT,45,32,1214,62,162,.383,37,107,.346,25,55,.455,.497,18,24,.750,47,142,189,52,36,20,37,113,179
486,P.J. Tucker\tuckepj01,PF,35,HOU,32,32,959,48,131,.366,27,86,.314,21,45,.467,.469,18,23,.783,33,115,148,45,29,18,33,91,141
486,P.J. Tucker\tuckepj01,PF,35,MIL,13,0,255,14,31,.452,10,21,.476,4,10,.400,.613,0,1,.000,14,27,41,7,7,2,4,22,38
487,Rayjon Tucker\tuckera01,PG,23,PHI,12,0,49,5,11,.455,2,5,.400,3,6,.500,.545,12,14,.857,1,8,9,5,2,0,3,5,24
488,Myles Turner\turnemy01,C,24,IND,47,47,1455,206,432,.477,69,206,.335,137,226,.606,.557,111,142,.782,63,243,306,48,40,159,67,165,592
489,Jonas Valančiūnas\valanjo01,C,28,MEM,55,54,1537,385,664,.580,21,55,.382,364,609,.598,.596,137,180,.761,223,455,678,100,31,42,91,158,928
490,Denzel Valentine\valende01,SG,27,CHI,57,3,979,147,390,.377,74,228,.325,73,162,.451,.472,14,15,.933,24,166,190,95,30,6,41,66,382
491,Jarred Vanderbilt\vandeja01,PF,21,MIN,57,25,977,119,199,.598,1,4,.250,118,195,.605,.601,54,96,.563,101,213,314,72,52,42,52,110,293
492,Fred VanVleet\vanvlfr01,SG,26,TOR,50,50,1813,321,821,.391,165,450,.367,156,371,.420,.491,163,184,.886,30,182,212,310,83,36,91,115,970
493,Devin Vassell\vassede01,SF,20,SAS,53,4,853,92,234,.393,45,120,.375,47,114,.412,.489,34,40,.850,19,119,138,46,39,15,18,73,263
494,Gabe Vincent\vincega01,PG,24,MIA,46,6,602,77,213,.362,39,136,.287,38,77,.494,.453,20,23,.870,10,39,49,55,19,2,30,73,213
495,Noah Vonleh\vonleno01,PF,25,BRK,4,0,11,0,3,.000,0,2,.000,0,1,.000,.000,0,0,,0,1,1,1,0,0,2,2,0
496,Nikola Vučević\vucevni01,C,30,TOT,64,64,2150,617,1274,.484,164,399,.411,453,875,.518,.549,127,152,.836,129,605,734,239,61,44,116,122,1525
496,Nikola Vučević\vucevni01,C,30,ORL,44,44,1500,436,908,.480,117,288,.406,319,620,.515,.545,91,110,.827,87,430,517,167,42,28,83,79,1080
496,Nikola Vučević\vucevni01,C,30,CHI,20,20,650,181,366,.495,47,111,.423,134,255,.525,.559,36,42,.857,42,175,217,72,19,16,33,43,445
497,Dean Wade\wadede01,PF,24,CLE,55,13,957,106,248,.427,63,171,.368,43,77,.558,.554,18,23,.783,30,139,169,63,25,19,21,60,293
498,Moritz Wagner\wagnemo01,C,23,TOT,37,16,506,75,161,.466,19,58,.328,56,103,.544,.525,51,64,.797,18,88,106,40,22,13,31,80,220
498,Moritz Wagner\wagnemo01,C,23,WAS,25,13,375,62,122,.508,13,42,.310,49,80,.613,.561,41,52,.788,13,60,73,32,22,8,21,62,178
498,Moritz Wagner\wagnemo01,C,23,BOS,9,1,61,4,14,.286,2,6,.333,2,8,.250,.357,1,2,.500,3,16,19,6,0,1,9,10,11
498,Moritz Wagner\wagnemo01,C,23,ORL,3,2,70,9,25,.360,4,10,.400,5,15,.333,.440,9,10,.900,2,12,14,2,0,4,1,8,31
499,Kemba Walker\walkeke02,PG,30,BOS,39,39,1227,244,597,.409,110,316,.348,134,281,.477,.501,112,122,.918,13,141,154,195,43,11,80,55,710
500,Lonnie Walker\walkelo01,SG,22,SAS,51,31,1286,218,513,.425,86,234,.368,132,279,.473,.509,55,68,.809,11,118,129,82,24,15,56,91,577
501,John Wall\walljo01,PG,30,HOU,40,40,1288,293,726,.404,79,249,.317,214,477,.449,.458,158,211,.749,17,112,129,275,42,31,141,46,823
502,Brad Wanamaker\wanambr01,PG,31,TOT,57,0,958,106,281,.377,16,84,.190,90,197,.457,.406,77,87,.885,14,80,94,159,39,11,67,87,305
502,Brad Wanamaker\wanambr01,PG,31,GSW,39,0,625,61,173,.353,13,61,.213,48,112,.429,.390,50,56,.893,8,58,66,99,26,6,37,55,185
502,Brad Wanamaker\wanambr01,PG,31,CHO,18,0,333,45,108,.417,3,23,.130,42,85,.494,.431,27,31,.871,6,22,28,60,13,5,30,32,120
503,T.J. Warren\warretj01,SF,27,IND,4,4,117,27,51,.529,0,7,.000,27,44,.614,.529,8,10,.800,2,12,14,5,2,0,4,16,62
504,P.J. Washington\washipj01,PF,22,CHO,57,54,1710,266,593,.449,96,242,.397,170,351,.484,.530,100,133,.752,79,277,356,145,55,73,117,152,728
505,Yuta Watanabe\watanyu01,SF,26,TOR,46,1,637,70,154,.455,31,76,.408,39,78,.500,.555,22,27,.815,35,108,143,35,22,19,17,54,193
506,Tremont Waters\watertr01,PG,23,BOS,21,2,159,19,49,.388,8,22,.364,11,27,.407,.469,13,14,.929,3,9,12,45,13,0,19,13,59
507,Paul Watson\watsopa01,SF,26,TOR,27,2,297,38,82,.463,30,64,.469,8,18,.444,.646,5,8,.625,4,41,45,17,6,3,9,36,111
508,Quinndary Weatherspoon\weathqu01,SG,24,SAS,17,0,76,6,16,.375,0,2,.000,6,14,.429,.375,7,8,.875,2,4,6,5,6,2,9,13,19
509,Russell Westbrook\westbru01,PG,32,WAS,57,57,2042,476,1082,.440,72,229,.314,404,853,.474,.473,226,355,.637,96,540,636,627,76,19,279,161,1250
510,Coby White\whiteco01,PG,20,CHI,61,46,1888,325,787,.413,131,380,.345,194,407,.477,.496,122,134,.910,23,224,247,284,34,13,137,159,903
511,Derrick White\whitede01,SG,26,SAS,36,32,1064,186,453,.411,84,243,.346,102,210,.486,.503,97,114,.851,13,94,107,127,26,36,45,91,553
512,Hassan Whiteside\whiteha01,C,31,SAC,36,4,546,126,224,.563,0,1,.000,126,223,.565,.563,41,79,.519,61,154,215,20,9,46,40,73,293
513,Greg Whittington\whittgr01,PF,27,DEN,4,0,12,0,3,.000,0,2,.000,0,1,.000,.000,0,0,,0,0,0,0,0,0,0,0,0
514,Andrew Wiggins\wiggian01,PF,25,GSW,64,64,2118,438,928,.472,125,329,.380,313,599,.523,.539,158,223,.709,69,236,305,152,63,64,117,140,1159
515,Grant Williams\willigr01,PF,22,BOS,56,8,1014,90,209,.431,43,115,.374,47,94,.500,.533,22,40,.550,43,111,154,54,30,21,49,142,245
516,Kenrich Williams\willike04,PF,26,OKC,64,12,1373,205,387,.530,47,109,.431,158,278,.568,.590,36,63,.571,83,183,266,143,50,15,72,136,493
517,Lou Williams\willilo02,PG,34,TOT,59,4,1314,246,599,.411,64,162,.395,182,437,.416,.464,143,166,.861,20,103,123,201,47,6,97,58,699
517,Lou Williams\willilo02,PG,34,LAC,42,3,918,181,430,.421,45,119,.378,136,311,.437,.473,103,119,.866,15,73,88,144,39,4,66,42,510
517,Lou Williams\willilo02,PG,34,ATL,17,1,396,65,169,.385,19,43,.442,46,126,.365,.441,40,47,.851,5,30,35,57,8,2,31,16,189
518,Patrick Williams\willipa01,PF,19,CHI,63,63,1776,226,472,.479,48,124,.387,178,348,.511,.530,79,107,.738,54,233,287,87,55,40,86,114,579
519,Robert Williams\williro04,C,23,BOS,50,11,953,180,251,.717,0,2,.000,180,249,.723,.717,45,71,.634,130,220,350,91,42,89,51,103,405
520,Zion Williamson\willizi01,PF,20,NOP,59,59,1952,614,996,.616,10,32,.313,604,964,.627,.621,354,510,.694,157,264,421,218,53,37,157,134,1592
521,D.J. Wilson\wilsodj01,PF,24,TOT,35,1,433,68,168,.405,30,87,.345,38,81,.469,.494,17,25,.680,20,92,112,23,11,16,22,44,183
521,D.J. Wilson\wilsodj01,PF,24,MIL,12,0,105,16,43,.372,10,28,.357,6,15,.400,.488,1,2,.500,3,22,25,3,1,4,4,13,43
521,D.J. Wilson\wilsodj01,PF,24,HOU,23,1,328,52,125,.416,20,59,.339,32,66,.485,.496,16,23,.696,17,70,87,20,10,12,18,31,140
522,Dylan Windler\windldy01,SF,24,CLE,31,0,513,57,130,.438,26,77,.338,31,53,.585,.538,21,27,.778,20,87,107,33,19,12,32,37,161
523,Justise Winslow\winslju01,SF,24,MEM,24,0,464,65,191,.340,6,48,.125,59,143,.413,.356,17,29,.586,16,87,103,44,15,12,34,43,153
524,Cassius Winston\winstca01,PG,22,WAS,20,0,97,14,33,.424,8,17,.471,6,16,.375,.545,5,6,.833,0,9,9,12,2,1,5,8,41
525,James Wiseman\wisemja01,C,19,GSW,39,27,836,191,368,.519,12,38,.316,179,330,.542,.535,54,86,.628,55,171,226,26,11,36,60,121,448
526,Christian Wood\woodch01,C,25,HOU,41,41,1326,329,640,.514,77,206,.374,252,434,.581,.574,125,198,.631,76,319,395,71,34,48,80,88,860
527,Robert Woodard\woodaro01,SF,21,SAC,11,0,29,7,14,.500,1,4,.250,6,10,.600,.536,3,8,.375,3,8,11,0,0,2,1,2,18
528,Delon Wright\wrighde01,SG-PG,28,TOT,55,31,1475,193,421,.458,49,133,.368,144,288,.500,.517,97,122,.795,52,170,222,229,82,23,66,64,532
528,Delon Wright\wrighde01,SG,28,DET,36,31,1052,136,293,.464,31,89,.348,105,204,.515,.517,71,90,.789,37,127,164,181,58,19,48,45,374
528,Delon Wright\wrighde01,PG,28,SAC,19,0,423,57,128,.445,18,44,.409,39,84,.464,.516,26,32,.813,15,43,58,48,24,4,18,19,158
529,Thaddeus Young\youngth01,PF,32,CHI,60,18,1452,331,574,.577,10,37,.270,321,537,.598,.585,58,92,.630,147,222,369,259,68,33,118,142,730
530,Trae Young\youngtr01,PG,22,ATL,56,56,1913,432,995,.434,129,359,.359,303,636,.476,.499,437,498,.878,35,181,216,527,50,11,236,103,1430
531,Cody Zeller\zelleco01,C,28,CHO,40,20,819,143,263,.544,4,26,.154,139,237,.586,.551,68,93,.731,100,169,269,74,23,14,41,93,358
532,Ivica Zubac\zubaciv01,C,23,LAC,65,26,1461,233,362,.644,0,3,.000,233,359,.649,.644,127,162,.784,177,297,474,81,24,56,75,170,593